Marko	Marko	1,nomo
esti	to be	1,radiko
as	Verb in present tense	1,finaĵo
mi	I	1,pronomo
a	Adjective	1,finaĵo
amiko	friend	1,radiko
o	Noun	1,finaĵo
li	he	1,pronomo
lerni	to learn	1,radiko
ant	present active	1,participo
kaj	and	1,konjunkcio
sporto	sport	1,radiko
ist	profession, habitual association	1,sufikso
nun	now	1,adverbo
sidi	to sit	1,radiko
en	in	1,prepozicio
ĉambro	បន្ទប់	1,radiko
sur	on	1,prepozicio
tablo	តារាង	1,radiko
papero	ក្រដាស	1,radiko
j	Plural	1,finaĵo
libro	book	1,radiko
ĝi	it	1,pronomo
skribi	to write	1,radiko
la	the	1,artikolo
patro	ឪពុក	1,radiko
in	female	1,sufikso
de	of, from	1,prepozicio
ne	no, not	1,partikulo
ili	they	1,pronomo
labori	to work	1,radiko
hotelo	សណ្ឋាគារ	1,radiko
instrui	to teach	1,radiko
ŝi	she	1,pronomo
havi	to have	2,radiko
n	Accusative case	2,finaĵo
nomo	ឈ្មោះ	2,radiko
Ana	Ana	2,nomo
juna	young	2,radiko
bela	ស្រស់ស្អាត	2,radiko
ge	pertaining of both sexes	2,prefikso
veni	មក	2,radiko
is	Verb in past tense	2,finaĵo
al	to, in the direction of	2,prepozicio
hejmo	home	2,radiko
bona	ល្អ	2,radiko
voli	want	2,radiko
u	Imperative verb	2,finaĵo
iri	to go	2,radiko
i	Infinitive	2,finaĵo
saluto	hello	2,radiko
kio	what	2,tabelvorto
vi	you (can be both singular and plural)	2,pronomo
fari	to do	2,radiko
legi	to read	2,radiko
sed	but	2,konjunkcio
paroli	to speak	2,radiko
kun	with	2,prepozicio
ĉu	whether (starts questions)	2,partikulo
jes	yes	2,adverbo
ŝati	to like	2,radiko
nur	only	2,adverbo
trinki	to drink	2,radiko
kafo	កាហ្វេ	2,radiko
frato	brother	2,radiko
jen	here is	2,partikulo
ankoraŭ	still, yet	2,adverbo
varma	warm	2,radiko
kuiri	to cook	2,radiko
danki	to thank	2,radiko
povi	can	2,radiko
ankaŭ	also	2,adverbo
mal	opposite	2,prefikso
rigardi	to look at	2,radiko
okulo	eye	2,radiko
vidi	to see	2,radiko
ke	that	2,konjunkcio
ami	love	2,radiko
longa	long	3,radiko
e	Adverb	3,finaĵo
antaŭ	before, in front of	3,prepozicio
ej	place	3,sufikso
post	after	3,prepozicio
ĝoja	glad	3,radiko
tra	through	3,prepozicio
strato	តាមផ្លូវ	3,radiko
tago	day	3,radiko
kuko	នំ	3,radiko
ni	we	3,pronomo
manĝi	to eat	3,radiko
diri	to say	3,radiko
sufiĉa	sufficient	3,radiko
mono	ប្រាក់	3,radiko
kompreni	to understand	3,radiko
ebl	possibility	3,sufikso
cent	មួយ​រយ	3,cifero
dolaro	dollar	3,radiko
ho	oh	3,interjekcio
riĉa	សម្បូរបែប	3,radiko
kelnero	waiter	3,radiko
porti	to carry	3,radiko
multa	មនុស្សជាច្រើន	3,radiko
nova	ថ្មី	3,radiko
serĉi	to search	3,radiko
unu	មួយ	3,cifero
loko	place	3,radiko
alia	ផ្សេងទៀត	3,radiko
vizaĝo	face	3,radiko
fini	to end	3,radiko
per	by means of, with	3,prepozicio
forta	strong	3,radiko
voĉo	voice	3,radiko
okazi	to happen	3,radiko
scii	to know	3,radiko
letero	letter	4,radiko
vera	true	4,radiko
foto	photo	4,radiko
kiam	when	4,tabelvorto
re	again, re-	4,prefikso
el	from, out of	4,prepozicio
rapida	fast	4,radiko
tie	there	4,tabelvorto
stari	to stand	4,radiko
Vera	Vera	4,nomo
mano	hand	4,radiko
koleri	anger	4,radiko
iĝ	become	4,sufikso
ruĝa	ក្រហម	4,radiko
fali	to fall	4,radiko
pardoni	to forgive	4,radiko
doni	to give	4,radiko
ricevi	to receive	4,radiko
leciono	lesson	4,radiko
plu	further, anymore	4,adverbo
os	Verb in future tense	4,finaĵo
devi	must	4,radiko
fermi	to close	4,radiko
pordo	ទ្វារ	4,radiko
sinjoro	gentleman, Mr.	5,radiko
vendi	to sell	5,radiko
aŭto	ឡាន	5,radiko
kiu	who, which	5,tabelvorto
plaĉi	to be pleasing	5,radiko
demandi	to ask	5,radiko
plej	most (superlative)	5,adverbo
tiu	that person, that one	5,tabelvorto
ĉi	this	5,partikulo
ĉiu	everyone, every	5,tabelvorto
pli	more (comparative)	5,adverbo
ol	than	5,konjunkcio
tre	very	5,adverbo
certa	certain	5,radiko
kosti	to cost	5,radiko
bedaŭri	to regret	5,radiko
ind	worthy of	5,sufikso
aĉeti	to buy	5,radiko
ĉar	because, for	5,konjunkcio
veturi	to travel	5,radiko
dum	during	5,prepozicio
tio	that	5,tabelvorto
edzo	ប្តី	5,radiko
Maja	Maja	6,nomo
et	small, diminutive	6,sufikso
ul	person	6,sufikso
tri	បី	6,cifero
ig	cause something	6,sufikso
sana	healthy	6,radiko
alta	ខ្ពស់	6,radiko
temperaturo	temperature	6,radiko
resti	to remain	6,radiko
morgaŭ	tomorrow	6,adverbo
voki	to call	6,radiko
doktoro	doctor	6,radiko
je	of, with, in	6,prepozicio
naŭ	ប្រាំបួន	6,cifero
horo	hour	6,radiko
por	for	6,prepozicio
helpi	to help	6,radiko
montri	to show	6,radiko
piedo	foot	6,radiko
vesti	to dress	6,radiko
ĉio	everything	6,tabelvorto
fine	at the end	6,vorto
semajno	week	6,radiko
sub	under, beneath	6,prepozicio
teo	តែ	6,radiko
mateno	ព្រឹក	6,radiko
vespero	ល្ងាច	6,radiko
deziri	to wish	6,radiko
trankvila	calm	6,radiko
farti	feel, be	6,radiko
eg	big, augmentative	6,sufikso
Karlo	Karlo	6,nomo
hm	hm	6,interjekcio
dormi	sleep	7,radiko
suno	ព្រះអាទិត្យ	7,radiko
subita	suddenly	7,radiko
ek	beginning of action, suddenness	7,prefikso
salti	to jump	7,radiko
ĉiam	always, every time	7,tabelvorto
frua	early	7,radiko
hodiaŭ	today	7,adverbo
meti	to put	7,radiko
aĵ	thing, concrete manifestation	7,sufikso
kuri	to run	7,radiko
laŭ	according to, along	7,prepozicio
homo	human	7,radiko
kia	what kind of	7,tabelvorto
saĝa	wise	7,radiko
knabo	boy	7,radiko
baldaŭ	soon	7,adverbo
it	past passive	7,participo
nek	neither (… nor)	7,konjunkcio
pensi	to think	7,radiko
diablo	devil	7,radiko
memori	to remember	7,radiko
dimanĉo	កាលពីថ្ងៃអាទិត្យ	7,radiko
raporti	report	8,radiko
noto	note	8,radiko
aĉ	indicates undesirable quality	8,sufikso
kapo	head	8,radiko
kiom	how much	8,tabelvorto
da	of	8,prepozicio
ĉe	at	8,prepozicio
ludi	to play	8,radiko
mem	self	8,partikulo
tiom	that much	8,tabelvorto
kvankam	although	8,konjunkcio
tiam	then	8,tabelvorto
aŭdi	to hear	8,radiko
vorto	ពាក្យ	8,radiko
tuj	immediately	8,adverbo
respondi	to answer	8,radiko
kara	dear	8,radiko
problemo	បញ្ហា	8,radiko
pri	about, concerning	8,prepozicio
muziko	តន្ត្រី	8,radiko
ridi	to laugh	8,radiko
tamen	however	8,adverbo
Petro	Petro	9,nomo
Maria	Maria	9,nomo
vojaĝi	journey	9,radiko
lando	land	9,radiko
libera	free	9,radiko
tempo	time	9,radiko
decidi	to decide	9,radiko
italio	Italy	9,radiko
urbo	ទីក្រុង	9,radiko
feliĉa	សប្បាយរីករាយ	9,radiko
kie	where	9,tabelvorto
forgesi	to forget	9,radiko
esperi	to hope	9,radiko
us	Verb in conditional tense	9,finaĵo
komenci	to begin	9,radiko
jam	already	9,adverbo
vagono	coach	9,radiko
ar	group, collection	9,sufikso
nenio	nothing	9,tabelvorto
sekreto	secret	9,radiko
onklo	ពូ	9,radiko
Bonifacio	Bonifacio	9,nomo
plena	full	9,radiko
um	indefinite meaning	9,sufikso
sia	reflexive pronoun	9,radiko
uzi	to use	9,radiko
domo	house	9,radiko
ad	continuous action	9,sufikso
atendi	to wait	9,radiko
do	so	9,adverbo
kial	why	9,tabelvorto
neniam	never, no time	9,tabelvorto
kiel	how	10,tabelvorto
pasi	to pass	10,radiko
naski	to give birth	10,radiko
kelka	some	10,radiko
familio	ក្រុមគ្រួសារ	10,radiko
an	member of a group	10,sufikso
iom	to some extent, a certain amount	10,tabelvorto
trovi	to find	10,radiko
almenaŭ	at least	10,adverbo
ordo	to order	10,radiko
io	something	10,tabelvorto
manki	be lacking	10,radiko
lakto	milk	10,radiko
necesa	to need	10,radiko
anstataŭ	instead of	10,prepozicio
intereso	to interest	10,radiko
ekskurso	excursion	10,radiko
klubo	club	10,radiko
ĵeti	to throw	10,radiko
ia	some kind of	10,tabelvorto
uj	container, tree, country	10,sufikso
ĝusta	to correct	10,radiko
for	away, off	10,prefikso
inter	between, among	10,prepozicio
sama	ដូចគ្នា	10,radiko
fojo	time, occasion	10,radiko
rajti	to be allowed to	10,radiko
proponi	to propose	10,radiko
du	ពីរ	10,cifero
parto	part	10,radiko
sukceso	success	10,radiko
iu	someone	10,tabelvorto
ideo		10,novaj
tro	too, too much	10,adverbo
ec	abstract quality	10,sufikso
reala	real	10,radiko
silento	silent	10,radiko
daŭri	to continue	10,radiko
nu	na	10,interjekcio
minuto	minute	10,radiko
telefono	ទូរស័ព្ទ	10,radiko
viziti	to visit	10,radiko
dolĉa	ផ្អែម	10,radiko
atenti	pay attention	10,radiko
dika	thick, fat	10,radiko
ŝanĝi	to change	10,radiko
opinii	opinion	10,radiko
sen	without	10,prepozicio
sola	alone	10,radiko
Veneci	Venice	11,radiko
Sankt-Mark	Saint Marcus	11,nomo
placo	place	11,radiko
milito	war	11,radiko
maro	សមុទ្រ	11,radiko
ŝipo	ship	11,radiko
gondolo	gondola	11,radiko
movi	to move	11,radiko
mezo	middle	11,radiko
proksima	នៅក្បែរ	11,radiko
granda	big, great	11,radiko
oni	one (indefinite pronoun)	11,pronomo
facila	easy	11,radiko
lumo	light	11,radiko
flanko	side	11,radiko
Stefan	Stephen	11,nomo
krii	to scream	11,radiko
turko	Turkish	11,radiko
renkonti	to meet	11,radiko
sekvi	to follow	11,radiko
Pietro	Pietro	11,nomo
koni	to know	11,radiko
akvo	water	11,radiko
tiel	like that, thus	11,tabelvorto
Ĝorĝo	George	11,nomo
preni	to take	11,radiko
estro	chief, head	11,sufikso
preskaŭ	almost	11,adverbo
morti	to die	11,radiko
grava	សំខាន់	11,radiko
Ĝino	Ĝino	11,nomo
halti	to stop	11,radiko
apud	next to	11,prepozicio
dek	ទាំងដប់	11,cifero
jaro	year	11,radiko
koloro	color	11,radiko
Jakopo	Jacob	11,nomo
tial	for that reason	11,tabelvorto
timi	fear	11,radiko
sendi	to send	11,radiko
doĝo	doge	11,radiko
bezoni	to need	11,radiko
pagi	to pay	11,radiko
er	fragment, small piece, particle	11,sufikso
afero	matter	11,radiko
se	if	11,konjunkcio
pano	នំបុ័ង	11,radiko
Don Kamilo	Don Camillus	11,nomo
ĝis	until	11,prepozicio
S-ro	លោក	12,mallongigo
Pipelbom	Pipelbom	12,nomo
peza	ធ្ងន់	12,radiko
larĝa	wide	12,radiko
korpo	body	12,radiko
aspekto	look, seem	12,radiko
rolo	role	12,radiko
fakto	fact	12,radiko
respekti	to respect	12,radiko
kontenta	satisfied	12,radiko
ofte	often	12,radiko
utila	useful	12,radiko
prezenti	to present	12,radiko
ĝeni	to distrub, to bother	12,radiko
nokto	យប់	12,radiko
arbo	ដើមឈើ	12,radiko
ĉefo	boss	12,radiko
vojo	way	12,radiko
ekster	outside of	12,prepozicio
sovaĝa	wild	12,radiko
bruo	noise	12,radiko
krom	besides, in addition to	12,prepozicio
tuŝi	to touch	12,radiko
naturo	nature	12,radiko
ĝenerali	general	12,radiko
seki	dry	12,radiko
paŝi	step	12,radiko
vivi	to live	12,radiko
dolori	pain, to hurt	12,radiko
agrabla	pleasant	12,radiko
ju	the (more, less)	12,partikulo
kastelo	castle	12,radiko
des	the (more, less)	12,partikulo
Adriano	Adriano	12,nomo
viro	man	12,radiko
kapabla	capable	12,radiko
industrio	industry	12,radiko
polico	police	12,radiko
persono	person	12,radiko
simila	similar	12,radiko
lasta	last	12,radiko
laŭta	loud	12,radiko
orelo	ear	12,radiko
momento	moment	12,radiko
ambaŭ	both	12,adverbo
direkti	direction	12,radiko
zorgi	care	12,radiko
situacio	sitation	12,radiko
branĉo	branch	12,radiko
rekta	direct	12,radiko
besto	សត្វ	12,radiko
promeni	to stroll	12,radiko
kavo	cave	12,radiko
odoro	smell	12,radiko
preta	ready	12,radiko
ajn	any, at all, -ever	12,partikulo
efektiva	actually	12,radiko
miri	to wonder	12,radiko
koro	heart	12,radiko
ŝajni	seem	12,radiko
supri	above	12,radiko
buŝo	មាត់	12,radiko
provi	to try	12,radiko
kapti	to catch	12,radiko
lampo	ចង្កៀង	12,radiko
paco	សន្តិភាព	12,radiko
formo	form	12,radiko
teni	hold	12,radiko
sono	to sound	12,radiko
aŭtoritato	authority	12,radiko
nuuuu	nuuuu	12,interjekcio
eee	eee	12,interjekcio
fuŝi	to mess up	12,radiko
klara	clear	12,radiko
eĉ	even	12,adverbo
tono	tone	12,radiko
ha	ha	12,interjekcio
bieno	estate, land	12,radiko
grafo	count, earl	12,radiko
monto	ភ្នំ	12,radiko
kalva	bald	12,radiko
inviti	to invite	12,radiko
peti	to request	12,radiko
teroro	terror	12,radiko
kontroli	to check	12,radiko
ĉirkaŭ	around	12,prepozicio
akcepti	ទទួលយក	12,radiko
perdi	to loose	12,radiko
