Marko	Marko	1,nomo
esti	olmak, -dir, -im vs (yardımcı fiil)	1,radiko
as	Fiil şimdiki zaman eki	1,finaĵo
mi	ben	1,pronomo
a	Sıfat eki	1,finaĵo
amiko	arkadaş	1,radiko
o	İsim eki	1,finaĵo
li	o (erkek)	1,pronomo
lerni	öğrenmek	1,radiko
ant	şimdiki zaman aktif	1,participo
kaj	ve	1,konjunkcio
sporto	spor	1,radiko
ist	meslek	1,sufikso
nun	şimdi	1,adverbo
sidi	oturmak	1,radiko
en	-e, -ye, içeri, içine	1,prepozicio
ĉambro	oda	1,radiko
sur	üstünde	1,prepozicio
tablo	masa	1,radiko
papero	kağıt	1,radiko
j	Çoğul eki	1,finaĵo
libro	kitap	1,radiko
ĝi	o (nötr)	1,pronomo
skribi	yazmak	1,radiko
la	(belirleyici artikel)	1,artikolo
patro	baba	1,radiko
in	kadın	1,sufikso
de	-den	1,prepozicio
ne	hayır, (olumsuzluk kelimesi)	1,partikulo
ili	onlar	1,pronomo
labori	çalışmak	1,radiko
hotelo	otel	1,radiko
instrui	öğretmek	1,radiko
ŝi	o (kadın)	1,pronomo
havi	sahip olmak	2,radiko
n	Akuzatif durumu eki	2,finaĵo
nomo	isim	2,radiko
Ana	Anna	2,nomo
juna	genç	2,radiko
bela	güzel	2,radiko
ge	her iki cinse dair	2,prefikso
veni	gelmek	2,radiko
is	Fiil geçmiş zaman eki	2,finaĵo
al	-e, -a, yönünde	2,prepozicio
hejmo	ev	2,radiko
bona	iyi	2,radiko
voli	istemek	2,radiko
u	Fiil emir eki	2,finaĵo
iri	gitmek	2,radiko
i	Fiil mastar formu eki	2,finaĵo
saluto	merhaba	2,radiko
kio	ne	2,tabelvorto
vi	sen, siz (tekil ve çoğul)	2,pronomo
fari	yapmak	2,radiko
legi	okumak	2,radiko
sed	fakat, ama	2,konjunkcio
paroli	konuşmak	2,radiko
kun	ile	2,prepozicio
ĉu	mu? mıdır? vs (Soru cümlesi başlatır)	2,partikulo
jes	Evet	2,adverbo
ŝati	beğenmek	2,radiko
nur	yalnız	2,adverbo
trinki	içmek	2,radiko
kafo	kahve	2,radiko
frato	kardeş	2,radiko
jen	işte	2,partikulo
ankoraŭ	hala	2,adverbo
varma	sıcak	2,radiko
kuiri	yemek yapmak, pişirmek	2,radiko
danki	teşekkür etmek	2,radiko
povi	yapabilmek, edebilmek, -bilmek	2,radiko
ankaŭ	de, da	2,adverbo
mal	zıt	2,prefikso
rigardi	bakmak	2,radiko
okulo	göz	2,radiko
vidi	görmek	2,radiko
ke	ki	2,konjunkcio
ami	sevmek; sevgi, aşk	2,radiko
longa	uzun	3,radiko
e	Zarf eki	3,finaĵo
antaŭ	önce, önünde	3,prepozicio
ej	yer	3,sufikso
post	sonra	3,prepozicio
ĝoja	memnun, hoşnut	3,radiko
tra	içinden	3,prepozicio
strato	sokak	3,radiko
tago	gün	3,radiko
kuko	kek	3,radiko
ni	biz	3,pronomo
manĝi	yemek	3,radiko
diri	söylemek, demek	3,radiko
sufiĉa	yeterli	3,radiko
mono	para	3,radiko
kompreni	anlamak, kavramak	3,radiko
ebl	olasılık	3,sufikso
cent	yüz	3,cifero
dolaro	dolar	3,radiko
ho	oh	3,interjekcio
riĉa	zengin	3,radiko
kelnero	garson	3,radiko
porti	taşımak, giyior olmak	3,radiko
multa	çok	3,radiko
nova	yeni	3,radiko
serĉi	aramak	3,radiko
unu	bir	3,cifero
loko	yer, lokasyon	3,radiko
alia	diğer	3,radiko
vizaĝo	yüz	3,radiko
fini	bitirmek	3,radiko
per	aracılığı ile, ile	3,prepozicio
forta	güçlü	3,radiko
voĉo	ses	3,radiko
okazi	olmak, vuku bulmak	3,radiko
scii	bilmek	3,radiko
letero	mektup	4,radiko
vera	doğru, gerçek	4,radiko
foto	fotoğraf	4,radiko
kiam	ne zaman	4,tabelvorto
re	tekrar, geriye	4,prefikso
el	-den, -den dışarı	4,prepozicio
rapida	hızlı	4,radiko
tie	orada	4,tabelvorto
stari	ayakta durmak, dikilmek	4,radiko
Vera	Vera	4,nomo
mano	el	4,radiko
koleri	sinir	4,radiko
iĝ	olmak (geçişsiz fiil oluşturur)	4,sufikso
ruĝa	kırmızı	4,radiko
fali	düşmek	4,radiko
pardoni	bağışlamak	4,radiko
doni	vermek	4,radiko
ricevi	teslim almak	4,radiko
leciono	ders	4,radiko
plu	ileriye, daha fazla	4,adverbo
os	Fiil gelecek zaman eki	4,finaĵo
devi	zorunda olmak	4,radiko
fermi	kapatmak	4,radiko
pordo	kapı	4,radiko
sinjoro	beyefendi, sayın	5,radiko
vendi	satmak	5,radiko
aŭto	araba	5,radiko
kiu	kim, hangi	5,tabelvorto
plaĉi	memnu etmek	5,radiko
demandi	sormak	5,radiko
plej	en (üstünlük)	5,adverbo
tiu	bu kişi, bu şey	5,tabelvorto
ĉi	bu yakındaki	5,partikulo
ĉiu	her bir kişi	5,tabelvorto
pli	daha (kıyaslamalı)	5,adverbo
ol	-dan (karşılaştırma)	5,konjunkcio
tre	çok	5,adverbo
certa	kesin, emin olmak	5,radiko
kosti	tutmak, etmek (fiyat), maaliyet	5,radiko
bedaŭri	pişman olmak, esefle karşılamak	5,radiko
ind	değer	5,sufikso
aĉeti	satın almak	5,radiko
ĉar	çünkü	5,konjunkcio
veturi	arabayla gitmek	5,radiko
dum	sırasında	5,prepozicio
tio	bu	5,tabelvorto
edzo	koca	5,radiko
Maja	Maja	6,nomo
et	küçük	6,sufikso
ul	şahıs	6,sufikso
tri	üç	6,cifero
ig	bir şey yapmak (geçişli fiil oluşturur)	6,sufikso
sana	sağlıklı	6,radiko
alta	yüksek	6,radiko
temperaturo	sıcaklık	6,radiko
resti	geriye kalmak, arta kalmak	6,radiko
morgaŭ	yarın	6,adverbo
voki	seslenmek	6,radiko
doktoro	doktor	6,radiko
je	(genel edat)	6,prepozicio
naŭ	dokuz	6,cifero
horo	saat	6,radiko
por	için	6,prepozicio
helpi	yardım etmek	6,radiko
montri	göstermek	6,radiko
piedo	ayak	6,radiko
vesti	giyinmek	6,radiko
ĉio	herşey	6,tabelvorto
fine	sonunda	6,vorto
semajno	hafta	6,radiko
sub	altında	6,prepozicio
teo	çay	6,radiko
mateno	sabah	6,radiko
vespero	akşam	6,radiko
deziri	dilemek, arzu etmek	6,radiko
trankvila	sakin	6,radiko
farti	hissetmek(ruh/sağlık hali), olmak (iyi/kötü)	6,radiko
eg	büyük	6,sufikso
Karlo	Karlo	6,nomo
hm	hmm	6,interjekcio
dormi	uyku	7,radiko
suno	güneş	7,radiko
subita	aniden	7,radiko
ek	aksiyon başlangıc, ani başlangıç	7,prefikso
salti	zıplamak	7,radiko
ĉiam	her zaman	7,tabelvorto
frua	erken	7,radiko
hodiaŭ	bugüm	7,adverbo
meti	koymak	7,radiko
aĵ	şey, somut anlam	7,sufikso
kuri	koşmak	7,radiko
laŭ	uygun olarak, boyunca	7,prepozicio
homo	insan	7,radiko
kia	ne çeşit	7,tabelvorto
saĝa	akıllı	7,radiko
knabo	oğlan	7,radiko
baldaŭ	yakında	7,adverbo
it	geçmiş zaman pasif	7,participo
nek	ne o... ne de bu...	7,konjunkcio
pensi	düşünmek	7,radiko
diablo	şeytan	7,radiko
memori	hatırlamak	7,radiko
dimanĉo	Pazar	7,radiko
raporti	rapor vermek	8,radiko
noto	not	8,radiko
aĉ	istenmeyen kalite gösterir	8,sufikso
kapo	kafa	8,radiko
kiom	ne kadar	8,tabelvorto
da	(miktar belirtir)	8,prepozicio
ĉe	-de, -da	8,prepozicio
ludi	oynamak	8,radiko
mem	kendisi	8,partikulo
tiom	şu kadar	8,tabelvorto
kvankam	rağmen	8,konjunkcio
tiam	bu zaman	8,tabelvorto
aŭdi	duymak	8,radiko
vorto	kelime	8,radiko
tuj	hemen	8,adverbo
respondi	cevap vermek	8,radiko
kara	değerli, kıymetli	8,radiko
problemo	problem	8,radiko
pri	hakkında	8,prepozicio
muziko	müzik	8,radiko
ridi	gülmek	8,radiko
tamen	ancak	8,adverbo
Petro	Peter	9,nomo
Maria	Maria	9,nomo
vojaĝi	seyahat	9,radiko
lando	toprak	9,radiko
libera	serbest	9,radiko
tempo	zaman	9,radiko
decidi	karar vermek	9,radiko
italio	İtalya	9,radiko
urbo	şehir	9,radiko
feliĉa	mutlu	9,radiko
kie	nerede	9,tabelvorto
forgesi	unutmak	9,radiko
esperi	ummak, umut etmek	9,radiko
us	Fiil şartlı zaman/dilek kipi eki	9,finaĵo
komenci	başlamak	9,radiko
jam	şimdiden	9,adverbo
vagono	vagon	9,radiko
ar	grup, bir araya gelen şeylerin bütünü	9,sufikso
nenio	hiç birşey	9,tabelvorto
sekreto	gizli	9,radiko
onklo	amca	9,radiko
Bonifacio	Bonifacio	9,nomo
plena	dolu, full	9,radiko
um	belirsiz anlamı olan ek	9,sufikso
sia	dönüşlü zamir (kendi, kendisini)	9,radiko
uzi	kullanmak	9,radiko
domo	ev	9,radiko
ad	yinelenen aksiyon	9,sufikso
atendi	beklemek	9,radiko
do	dolayısı ile	9,adverbo
kial	neden	9,tabelvorto
neniam	hiç bir zaman	9,tabelvorto
kiel	nasıl	10,tabelvorto
pasi	geçmek	10,radiko
naski	doğurmak	10,radiko
kelka	bazı, bir kaç	10,radiko
familio	aile	10,radiko
an	grup uyesi	10,sufikso
iom	bir miktar	10,tabelvorto
trovi	bulmak	10,radiko
almenaŭ	hiç olmazsa, en azından	10,adverbo
ordo	emretmek, sipariş vermek	10,radiko
io	bir şey	10,tabelvorto
manki	eksik olmak	10,radiko
lakto	süt	10,radiko
necesa	ihtiyaç duymak	10,radiko
anstataŭ	yerine	10,prepozicio
intereso	ilgilenmek	10,radiko
ekskurso	gezinti	10,radiko
klubo	klup	10,radiko
ĵeti	fırlatmak, atmak	10,radiko
ia	bir çeşit	10,tabelvorto
uj	kap, ağaç, ülke	10,sufikso
ĝusta	düzeltmek	10,radiko
for	uzak, yok etme	10,prefikso
inter	arasında	10,prepozicio
sama	aynı	10,radiko
fojo	sefer, kez, sıklık	10,radiko
rajti	izni olmak	10,radiko
proponi	önermek	10,radiko
du	iki	10,cifero
parto	parça	10,radiko
sukceso	başarı	10,radiko
iu	bir kişi	10,tabelvorto
ideo		10,novaj
tro	aşırı, aşırı fazla	10,adverbo
ec	soyut kalite	10,sufikso
reala	gerçek	10,radiko
silento	sessiz	10,radiko
daŭri	devam etmek	10,radiko
nu	ee..., şimdi...	10,interjekcio
minuto	dakika	10,radiko
telefono	telefon	10,radiko
viziti	ziyaret etmek	10,radiko
dolĉa	tatlı	10,radiko
atenti	dikkat etmek	10,radiko
dika	kalın, şişman	10,radiko
ŝanĝi	değiştirmek	10,radiko
opinii	fikir	10,radiko
sen	olmaksızın, -sız, -siz vs	10,prepozicio
sola	yalnız	10,radiko
Veneci	Venedik	11,radiko
Sankt-Mark	Aziz Marko	11,nomo
placo	yer	11,radiko
milito	savaş	11,radiko
maro	deniz	11,radiko
ŝipo	gemi	11,radiko
gondolo	gondol	11,radiko
movi	hareket etmek	11,radiko
mezo	orta	11,radiko
proksima	yakın	11,radiko
granda	büyük	11,radiko
oni	birisi (belirsiz şahıs zamiri)	11,pronomo
facila	kolay	11,radiko
lumo	parlak	11,radiko
flanko	taraf	11,radiko
Stefan	Stephen	11,nomo
krii	çığlık atmak	11,radiko
turko	Türkçe	11,radiko
renkonti	tanışmak, karşılaşmak	11,radiko
sekvi	takip etmek	11,radiko
Pietro	Pietro	11,nomo
koni	bilmek	11,radiko
akvo	su	11,radiko
tiel	bu şekilde	11,tabelvorto
Ĝorĝo	George	11,nomo
preni	almak	11,radiko
estro	şef, baş, yönetici	11,sufikso
preskaŭ	hemen hemen, yaklaşık olarak	11,adverbo
morti	ölmek	11,radiko
grava	önemli	11,radiko
Ĝino	Ĝina	11,nomo
halti	durdurmak	11,radiko
apud	yanında	11,prepozicio
dek	on	11,cifero
jaro	yıl	11,radiko
koloro	renk	11,radiko
Jakopo	Jacob	11,nomo
tial	bu sebepten dolayı	11,tabelvorto
timi	korku	11,radiko
sendi	iletmek	11,radiko
doĝo	eski venedik başkanı	11,radiko
bezoni	ihtiyaç duymak	11,radiko
pagi	ödemek	11,radiko
er	küçük parça, partikül	11,sufikso
afero	mesele, konu, şey	11,radiko
se	eğer	11,konjunkcio
pano	ekmek	11,radiko
Don Kamilo	Don Camillus	11,nomo
ĝis	-e kadar	11,prepozicio
S-ro	Bay, Bey	12,mallongigo
Pipelbom	Pipelbom	12,nomo
peza	ağır	12,radiko
larĝa	geniş	12,radiko
korpo	beden	12,radiko
aspekto	görünmek, gözükmek	12,radiko
rolo	rol	12,radiko
fakto	aslında	12,radiko
respekti	saygı duymak	12,radiko
kontenta	tatmin olmak	12,radiko
ofte	sıkça	12,radiko
utila	kullanışlı, faydalı	12,radiko
prezenti	sunmak	12,radiko
ĝeni	can sıkmak, rahatsızlık vermek	12,radiko
nokto	gece	12,radiko
arbo	ağaç	12,radiko
ĉefo	patron	12,radiko
vojo	yol	12,radiko
ekster	dışında	12,prepozicio
sovaĝa	vahşi, yabani	12,radiko
bruo	gürültü	12,radiko
krom	hariç, ilaveten	12,prepozicio
tuŝi	dokunmak	12,radiko
naturo	doğa	12,radiko
ĝenerali	genel	12,radiko
seki	kuru	12,radiko
paŝi	adım, adımlamak	12,radiko
vivi	yaşamak	12,radiko
dolori	ağrı, acı, acımak	12,radiko
agrabla	hoş	12,radiko
ju	o kadar (fazla, az)	12,partikulo
kastelo	kale	12,radiko
des	ne kadar (fazla, az)	12,partikulo
Adriano	Adrian	12,nomo
viro	adam	12,radiko
kapabla	yetenekli	12,radiko
industrio	endüstri	12,radiko
polico	polis	12,radiko
persono	kişi	12,radiko
simila	benzer	12,radiko
lasta	son	12,radiko
laŭta	yüksek(ses)	12,radiko
orelo	kulak	12,radiko
momento	an	12,radiko
ambaŭ	her ikisi	12,adverbo
direkti	yön	12,radiko
zorgi	ilgilenmek, endişelenmek	12,radiko
situacio	durum	12,radiko
branĉo	dal	12,radiko
rekta	direk	12,radiko
besto	hayvan	12,radiko
promeni	dolaşmak	12,radiko
kavo	mağara	12,radiko
odoro	koku	12,radiko
preta	hazır olmak	12,radiko
ajn	herne, herhangi, herneyse	12,partikulo
efektiva	gerçekte	12,radiko
miri	hayret etmek	12,radiko
koro	kalp	12,radiko
ŝajni	gibi görünmek, sanki	12,radiko
supri	yukarı	12,radiko
buŝo	ağız	12,radiko
provi	denemek	12,radiko
kapti	yakalamak	12,radiko
lampo	lamba	12,radiko
paco	barış	12,radiko
formo	şekillendirmek, biçimlendirmek	12,radiko
teni	tutmak	12,radiko
sono	ses çıkarmak?	12,radiko
aŭtoritato	otorite	12,radiko
nuuuu	eeeee	12,interjekcio
eee	eee	12,interjekcio
fuŝi	batırmak, dağıtmak, yüzüne bulaştırmak	12,radiko
klara	net, açık	12,radiko
eĉ	bile	12,adverbo
tono	ton	12,radiko
ha	ah	12,interjekcio
bieno	arsa, malikane	12,radiko
grafo	Kont (soylu)	12,radiko
monto	dağ	12,radiko
kalva	kel	12,radiko
inviti	davet etmek	12,radiko
peti	rica etmek, talep etmek	12,radiko
teroro	terör, terörie etmek	12,radiko
kontroli	kontrol etmek	12,radiko
ĉirkaŭ	etraf	12,prepozicio
akcepti	kabul etmek	12,radiko
perdi	kaybetmek	12,radiko
