Marko	Marko	1,nomo
esti	vara, finnas	1,radiko
as	Verb i presens	1,finaĵo
mi	jag	1,pronomo
a	Adjektiv	1,finaĵo
amiko	vän	1,radiko
o	Substantiv	1,finaĵo
li	han	1,pronomo
lerni	lära sig	1,radiko
ant	aktiv pågående handling	1,participo
kaj	och	1,konjunkcio
sporto	sport	1,radiko
ist	en som ofta sysslar med något, yrkesman	1,sufikso
nun	nu	1,adverbo
sidi	sitta	1,radiko
en	i	1,prepozicio
ĉambro	rum	1,radiko
sur	på	1,prepozicio
tablo	bord	1,radiko
papero	papper	1,radiko
j	Plural	1,finaĵo
libro	bok	1,radiko
ĝi	den, det	1,pronomo
skribi	skriva	1,radiko
la	(bestämd artikel)	1,artikolo
patro	fader, far	1,radiko
in	kvinna, hona	1,sufikso
de	från, av	1,prepozicio
ne	nej, inte	1,partikulo
ili	de	1,pronomo
labori	arbete, jobb	1,radiko
hotelo	hotell	1,radiko
instrui	lära (någon), lära ut, undervisa	1,radiko
ŝi	hon	1,pronomo
havi	ha	2,radiko
n	Objekt	2,finaĵo
nomo	namn	2,radiko
Ana	Ana	2,nomo
juna	ung	2,radiko
bela	vacker, snygg	2,radiko
ge	bägge könen	2,prefikso
veni	komma	2,radiko
is	Verb i dåtid	2,finaĵo
al	till, åt	2,prepozicio
hejmo	hem	2,radiko
bona	bra, god	2,radiko
voli	vilja	2,radiko
u	Verb i imperativ	2,finaĵo
iri	gå, åka	2,radiko
i	Infinitiv	2,finaĵo
saluto	hälsa	2,radiko
kio	vad	2,tabelvorto
vi	du, ni	2,pronomo
fari	göra	2,radiko
legi	läsa	2,radiko
sed	men	2,konjunkcio
paroli	tala, prata	2,radiko
kun	(tillsammans) med	2,prepozicio
ĉu	(frågepartikeln), huruvida, månne, om	2,partikulo
jes	ja	2,adverbo
ŝati	tycka om, gilla	2,radiko
nur	bara, endast	2,adverbo
trinki	dricka	2,radiko
kafo	kaffe	2,radiko
frato	bror	2,radiko
jen	se här, här är	2,partikulo
ankoraŭ	ännu, fortfarande	2,adverbo
varma	varm	2,radiko
kuiri	laga (mat)	2,radiko
danki	tacka	2,radiko
povi	kunna	2,radiko
ankaŭ	även, också	2,adverbo
mal	motsatsen	2,prefikso
rigardi	titta	2,radiko
okulo	öga	2,radiko
vidi	se	2,radiko
ke	att	2,konjunkcio
ami	kärlek, älska	2,radiko
longa	lång	3,radiko
e	Adverb	3,finaĵo
antaŭ	framför, före	3,prepozicio
ej	plats, lokal	3,sufikso
post	efter	3,prepozicio
ĝoja	glad	3,radiko
tra	genom	3,prepozicio
strato	gata	3,radiko
tago	dag	3,radiko
kuko	kaka	3,radiko
ni	vi	3,pronomo
manĝi	äta	3,radiko
diri	säga	3,radiko
sufiĉa	tillräcklig	3,radiko
mono	pengar	3,radiko
kompreni	förstå	3,radiko
ebl	möjlig att göraas	3,sufikso
cent	hundra	3,cifero
dolaro	dollar	3,radiko
ho	åh	3,interjekcio
riĉa	rik	3,radiko
kelnero	kypare, servitör	3,radiko
porti	bära	3,radiko
multa	många	3,radiko
nova	ny	3,radiko
serĉi	söka, leta	3,radiko
unu	ett	3,cifero
loko	plats	3,radiko
alia	annan	3,radiko
vizaĝo	ansikte	3,radiko
fini	slut	3,radiko
per	med (hjälp av)	3,prepozicio
forta	stark	3,radiko
voĉo	röst	3,radiko
okazi	hända, inträffa	3,radiko
scii	veta	3,radiko
letero	brev	4,radiko
vera	sann, verklig	4,radiko
foto	foto	4,radiko
kiam	när	4,tabelvorto
re	åter, tillbaka, på nytt	4,prefikso
el	ut ur, utav (ursprung, urval m.m.)	4,prepozicio
rapida	snabb	4,radiko
tie	där	4,tabelvorto
stari	stå	4,radiko
Vera	Vera	4,nomo
mano	hand	4,radiko
koleri	arg	4,radiko
iĝ	bli	4,sufikso
ruĝa	röd	4,radiko
fali	falla	4,radiko
pardoni	förlåta	4,radiko
doni	ge	4,radiko
ricevi	få	4,radiko
leciono	lektion	4,radiko
plu	vidare, ytterligare, mer (om tid)	4,adverbo
os	Verb i futurum	4,finaĵo
devi	måsta, vara tvungen	4,radiko
fermi	stänga	4,radiko
pordo	dörr	4,radiko
sinjoro	herre, herr	5,radiko
vendi	sälja	5,radiko
aŭto	bil	5,radiko
kiu	vem, vilken	5,tabelvorto
plaĉi	behaga	5,radiko
demandi	fråga	5,radiko
plej	mest	5,adverbo
tiu	den där personen, den där, det där	5,tabelvorto
ĉi	(anger närhet), här	5,partikulo
ĉiu	alla, varje	5,tabelvorto
pli	mer	5,adverbo
ol	än (vid jämförelse)	5,konjunkcio
tre	mycket (i hög grad)	5,adverbo
certa	säker	5,radiko
kosti	kosta	5,radiko
bedaŭri	beklaga	5,radiko
ind	värd att göras	5,sufikso
aĉeti	köpa	5,radiko
ĉar	därför att, eftersom	5,konjunkcio
veturi	åka (med fordon)	5,radiko
dum	medan, under	5,prepozicio
tio	det där	5,tabelvorto
edzo	make, man	5,radiko
Maja	Maja	6,nomo
et	försvagning, förminskning	6,sufikso
ul	person med en viss egenskap	6,sufikso
tri	tre	6,cifero
ig	göra, förvandla, förmå	6,sufikso
sana	frisk	6,radiko
alta	hög	6,radiko
temperaturo	temperatur	6,radiko
resti	stanna kvar, förbli	6,radiko
morgaŭ	imorgon	6,adverbo
voki	kalla, ropa	6,radiko
doktoro	doktor	6,radiko
je	obestämd preposition	6,prepozicio
naŭ	nio	6,cifero
horo	timme	6,radiko
por	för	6,prepozicio
helpi	hjälpa	6,radiko
montri	visa, peka ut	6,radiko
piedo	fot	6,radiko
vesti	klä	6,radiko
ĉio	allting	6,tabelvorto
fine	till slut, slutligen	6,vorto
semajno	vecka	6,radiko
sub	under	6,prepozicio
teo	te	6,radiko
mateno	morgon	6,radiko
vespero	kväll	6,radiko
deziri	önska	6,radiko
trankvila	lugn	6,radiko
farti	må, känna sig	6,radiko
eg	förstärkning, förstoring	6,sufikso
Karlo	Karlo	6,nomo
hm	hm	6,interjekcio
dormi	sova	7,radiko
suno	sol	7,radiko
subita	plötslig	7,radiko
ek	börja, plötsligt, kortvarigt	7,prefikso
salti	hoppa	7,radiko
ĉiam	alltid	7,tabelvorto
frua	tidig	7,radiko
hodiaŭ	idag	7,adverbo
meti	sätta, ställa, lägga	7,radiko
aĵ	konkret sak, maträtt	7,sufikso
kuri	springa	7,radiko
laŭ	enligt, längs	7,prepozicio
homo	männsika	7,radiko
kia	hurdan	7,tabelvorto
saĝa	vis, klok	7,radiko
knabo	pojke	7,radiko
baldaŭ	snart	7,adverbo
it	passiv avslutad handling	7,participo
nek	varken (… eller)	7,konjunkcio
pensi	tänka, tycka	7,radiko
diablo	djävul	7,radiko
memori	minnas	7,radiko
dimanĉo	söndag	7,radiko
raporti	rapportera	8,radiko
noto	anteckning, betyg	8,radiko
aĉ	usel, dålig kvalitet	8,sufikso
kapo	huvud	8,radiko
kiom	hur mycket, hur många	8,tabelvorto
da	utav, med (mängd)	8,prepozicio
ĉe	hos, intill	8,prepozicio
ludi	spela, leka	8,radiko
mem	själv	8,partikulo
tiom	så mycket, så många	8,tabelvorto
kvankam	fastän	8,konjunkcio
tiam	då	8,tabelvorto
aŭdi	höra	8,radiko
vorto	ord	8,radiko
tuj	genast, omedelbart	8,adverbo
respondi	svara	8,radiko
kara	kär, älskad	8,radiko
problemo	problem	8,radiko
pri	om, angående	8,prepozicio
muziko	musik	8,radiko
ridi	skratta	8,radiko
tamen	ändå	8,adverbo
Petro	Petro	9,nomo
Maria	Maria	9,nomo
vojaĝi	resa	9,radiko
lando	land	9,radiko
libera	fri, ledig	9,radiko
tempo	tid	9,radiko
decidi	bestämma	9,radiko
italio	Italien	9,radiko
urbo	stad	9,radiko
feliĉa	lycklig	9,radiko
kie	var	9,tabelvorto
forgesi	glömma	9,radiko
esperi	hoppas	9,radiko
us	Verb i konditionalis	9,finaĵo
komenci	börja, påbörja	9,radiko
jam	redan	9,adverbo
vagono	järnvägsvagn	9,radiko
ar	samling	9,sufikso
nenio	ingenting	9,tabelvorto
sekreto	hemlighet	9,radiko
onklo	farbror, morbror	9,radiko
Bonifacio	Bonifacio	9,nomo
plena	full, fullständig	9,radiko
um	(obestämt suffix)	9,sufikso
sia	sig	9,radiko
uzi	använda	9,radiko
domo	hus	9,radiko
ad	(upprepad, varaktig) handling	9,sufikso
atendi	vänta	9,radiko
do	då, alltså	9,adverbo
kial	varför	9,tabelvorto
neniam	aldrig	9,tabelvorto
kiel	hur	10,tabelvorto
pasi	passera	10,radiko
naski	föda (barn)	10,radiko
kelka	några	10,radiko
familio	familj	10,radiko
an	medlem, anhängare, invånare	10,sufikso
iom	något, lite, en smula	10,tabelvorto
trovi	hitta	10,radiko
almenaŭ	åtmistone	10,adverbo
ordo	ordning	10,radiko
io	någonting	10,tabelvorto
manki	saknas, fattas	10,radiko
lakto	mjölk	10,radiko
necesa	nödvändig	10,radiko
anstataŭ	istället för	10,prepozicio
intereso	intressera	10,radiko
ekskurso	utflykt	10,radiko
klubo	klubb	10,radiko
ĵeti	kasta	10,radiko
ia	någon slags	10,tabelvorto
uj	behållare, träd/buske, land	10,sufikso
ĝusta	rätt, riktig	10,radiko
for	bort, iväg	10,prefikso
inter	mellan, bland	10,prepozicio
sama	samma, likadan	10,radiko
fojo	gång, tillfälle	10,radiko
rajti	få, ha rätt till	10,radiko
proponi	föreslå	10,radiko
du	två	10,cifero
parto	del	10,radiko
sukceso	lyckas	10,radiko
iu	någon, något	10,tabelvorto
ideo	idé	10,novaj
tro	allför (mycket)	10,adverbo
ec	egenskap	10,sufikso
reala	verklig	10,radiko
silento	tyst	10,radiko
daŭri	fortgå, pågå, vara	10,radiko
nu	nå	10,interjekcio
minuto	minut	10,radiko
telefono	telefon	10,radiko
viziti	besöka	10,radiko
dolĉa	söt	10,radiko
atenti	akta, uppmärksamma, se upp	10,radiko
dika	tjock	10,radiko
ŝanĝi	ändra, byta	10,radiko
opinii	åsikt	10,radiko
sen	utan	10,prepozicio
sola	ensam	10,radiko
Veneci	Venedig	11,radiko
Sankt-Mark	Helige Mark	11,nomo
placo	torg	11,radiko
milito	krig	11,radiko
maro	hav	11,radiko
ŝipo	båt, fartyg	11,radiko
gondolo	gondol	11,radiko
movi	(för)flytta	11,radiko
mezo	mitt	11,radiko
proksima	nära	11,radiko
granda	stor	11,radiko
oni	man	11,pronomo
facila	lätt, enkel	11,radiko
lumo	ljus	11,radiko
flanko	sida	11,radiko
Stefan	Stephen	11,nomo
krii	skrika	11,radiko
turko	turkisk	11,radiko
renkonti	möta, träffa	11,radiko
sekvi	följa	11,radiko
Pietro	Pietro	11,nomo
koni	känna (till)	11,radiko
akvo	vatten	11,radiko
tiel	så, på det sättet	11,tabelvorto
Ĝorĝo	George	11,nomo
preni	ta	11,radiko
estro	ledare	11,sufikso
preskaŭ	nästan	11,adverbo
morti	dö	11,radiko
grava	viktig	11,radiko
Ĝino	Ĝino	11,nomo
halti	stanna	11,radiko
apud	bredvid	11,prepozicio
dek	tio	11,cifero
jaro	år	11,radiko
koloro	färg	11,radiko
Jakopo	Jacob	11,nomo
tial	därför	11,tabelvorto
timi	rädsla	11,radiko
sendi	sända, skicka	11,radiko
doĝo	doge (hög ämbetsman i Venedig)	11,radiko
bezoni	behöva	11,radiko
pagi	betala	11,radiko
er	fragment, liten del, partikel	11,sufikso
afero	sak, företeelse	11,radiko
se	om	11,konjunkcio
pano	bröd	11,radiko
Don Kamilo	Don Camillus	11,nomo
ĝis	ända till	11,prepozicio
S-ro	Herr	12,mallongigo
Pipelbom	Pipelbom	12,nomo
peza	tung	12,radiko
larĝa	bred, vid	12,radiko
korpo	kropp	12,radiko
aspekto	se ut	12,radiko
rolo	roll	12,radiko
fakto	fakta	12,radiko
respekti	respektera	12,radiko
kontenta	nöjd	12,radiko
ofte	ofta	12,radiko
utila	nyttig, användbar	12,radiko
prezenti	presentera	12,radiko
ĝeni	störa, besvära	12,radiko
nokto	natt	12,radiko
arbo	träd	12,radiko
ĉefo	chef	12,radiko
vojo	väg	12,radiko
ekster	utanför	12,prepozicio
sovaĝa	vild	12,radiko
bruo	buller	12,radiko
krom	förutom, utom	12,prepozicio
tuŝi	röra, vidröra, beröra	12,radiko
naturo	natur	12,radiko
ĝenerali	generellt	12,radiko
seki	torr	12,radiko
paŝi	kliva, gå	12,radiko
vivi	leva	12,radiko
dolori	smärta, göra ont	12,radiko
agrabla	trevlig	12,radiko
ju	ju	12,partikulo
kastelo	slott	12,radiko
des	desto	12,partikulo
Adriano	Adriano	12,nomo
viro	man	12,radiko
kapabla	kapabel	12,radiko
industrio	industri	12,radiko
polico	polis	12,radiko
persono	person	12,radiko
simila	lik, liknande	12,radiko
lasta	sista	12,radiko
laŭta	hödljudd	12,radiko
orelo	öra	12,radiko
momento	ögonblick	12,radiko
ambaŭ	båda, bägge	12,adverbo
direkti	riktning	12,radiko
zorgi	bry sig	12,radiko
situacio	situation	12,radiko
branĉo	gren	12,radiko
rekta	rak, direkt	12,radiko
besto	djur	12,radiko
promeni	promenera	12,radiko
kavo	håla, hålighet	12,radiko
odoro	lukt	12,radiko
preta	färdig, redo	12,radiko
ajn	som helst	12,partikulo
efektiva	i själva verket	12,radiko
miri	förvånas, förundras	12,radiko
koro	hjärta	12,radiko
ŝajni	förefalla, tyckas, verka	12,radiko
supri	ovanför	12,radiko
buŝo	mun	12,radiko
provi	prova	12,radiko
kapti	fånga	12,radiko
lampo	lampa	12,radiko
paco	fred	12,radiko
formo	form	12,radiko
teni	hålla	12,radiko
sono	ljud	12,radiko
aŭtoritato	auktoritet, myndighet	12,radiko
nuuuu	nuuuu	12,interjekcio
eee	eee	12,interjekcio
fuŝi	slarva, fördärva	12,radiko
klara	klar, tydlig	12,radiko
eĉ	till och med, ens	12,adverbo
tono	ton	12,radiko
ha	ha	12,interjekcio
bieno	egendom, gård, gods	12,radiko
grafo	greve	12,radiko
monto	berg	12,radiko
kalva	flintskallig	12,radiko
inviti	bjuda in	12,radiko
peti	be (om något)	12,radiko
teroro	terror	12,radiko
kontroli	kontrollera	12,radiko
ĉirkaŭ	omkring, runt, cirka	12,prepozicio
akcepti	acceptera	12,radiko
perdi	tappa, mista, förlora	12,radiko
