Marko	Marko	1,nomo
esti	ialah,kata akar	1,radiko
as	Kata kerja menujukkan perbuatan kini	1,finaĵo
mi	saya	1,pronomo
a	Adjektif	1,finaĵo
amiko	kawan, kata akar	1,radiko
o	Kata Nama	1,finaĵo
li	dia (lelaki)	1,pronomo
lerni	belajar,kata akar	1,radiko
ant	imbuhan belakang untuk menjadikan kata kerja menujukkan perbuatan aktif kini	1,participo
kaj	dan	1,konjunkcio
sporto	sukan,kata akar	1,radiko
ist	pakar	1,sufikso
nun	sekarang	1,adverbo
sidi	duduk,kata akar	1,radiko
en	di dalam	1,prepozicio
ĉambro	bilik,kata akar	1,radiko
sur	di atas	1,prepozicio
tablo	meja,kata akar	1,radiko
papero	kertas,kata akar	1,radiko
j	Majmuk	1,finaĵo
libro	buku,kata akar	1,radiko
ĝi	dia (unutk binatang atau benda tidak bernyawa)	1,pronomo
skribi	tulis,kata akar	1,radiko
la	itu,ini	1,artikolo
patro	ayah,kata akar	1,radiko
in	betina	1,sufikso
de	dari	1,prepozicio
ne	tidak	1,partikulo
ili	mereka	1,pronomo
labori	bekerja,kata akar	1,radiko
hotelo	hotel,kata akar	1,radiko
instrui	mengajar,kata akar	1,radiko
ŝi	dia (perempuan)	1,pronomo
havi	mempunyai,kata akar	2,radiko
n	Akusatif	2,finaĵo
nomo	nama,kata akar	2,radiko
Ana	Ana	2,nomo
juna	muda,kata akar	2,radiko
bela	cantik,kata akar	2,radiko
ge	untuk menujukkan dua jantina	2,prefikso
veni	mari,kata akar	2,radiko
is	Kata kerja menujukkan perbuatan telah berlaku	2,finaĵo
al	ke	2,prepozicio
hejmo	rumah,kata akar	2,radiko
bona	bagus,kata akar	2,radiko
voli	ingin,kata akar	2,radiko
u	Kata kerja perintah	2,finaĵo
iri	pergi,kata akar	2,radiko
i	Kata kerja infinitif	2,finaĵo
saluto	salam hormat,kata akar	2,radiko
kio	apa	2,tabelvorto
vi	awak	2,pronomo
fari	membuat,kata akar	2,radiko
legi	baca,kata akar	2,radiko
sed	tetapi	2,konjunkcio
paroli	ucap,kata akar	2,radiko
kun	bersama	2,prepozicio
ĉu	sama ada	2,partikulo
jes	ia	2,adverbo
ŝati	suka,kata akar	2,radiko
nur	hanya	2,adverbo
trinki	minum,kata akar	2,radiko
kafo	kopi,kata akar	2,radiko
frato	adik atau abang,kata akar	2,radiko
jen	di sini	2,partikulo
ankoraŭ	juga, belum	2,adverbo
varma	panas,kata akar	2,radiko
kuiri	memasak,kata akar	2,radiko
danki	terima kasih,kata akar	2,radiko
povi	boleh,kata akar	2,radiko
ankaŭ	juga	2,adverbo
mal	bertentangan	2,prefikso
rigardi	melihat,kata akar	2,radiko
okulo	mata,kata akar	2,radiko
vidi	lihat,kata akar	2,radiko
ke	bahawa	2,konjunkcio
ami	sayang, kata akar, cinta, kata akar	2,radiko
longa	panjang,kata akar	3,radiko
e	Kata Keterangan	3,finaĵo
antaŭ	sebelum, di hadapan	3,prepozicio
ej	tempat	3,sufikso
post	selepas	3,prepozicio
ĝoja	gembira,kata akar	3,radiko
tra	melalui	3,prepozicio
strato	jalan,kata akar	3,radiko
tago	hari,kata akar	3,radiko
kuko	kek,kata akar	3,radiko
ni	kita	3,pronomo
manĝi	makan,kata akar	3,radiko
diri	mengata,kata akar	3,radiko
sufiĉa	cukup,kata akar	3,radiko
mono	duit,kata akar	3,radiko
kompreni	faham,kata akar	3,radiko
ebl	kemungkinan	3,sufikso
cent	seratus	3,cifero
dolaro	dolar,kata akar	3,radiko
ho	oh	3,interjekcio
riĉa	kaya,kata akar	3,radiko
kelnero	pelayan,kata akar	3,radiko
porti	angkat,kata akar	3,radiko
multa	ramai,kata akar	3,radiko
nova	baru,kata akar	3,radiko
serĉi	cari,kata akar	3,radiko
unu	satu	3,cifero
loko	tempat,kata akar	3,radiko
alia	lain, kata akar	3,radiko
vizaĝo	muka,kata akar	3,radiko
fini	mengakhiri,kata akar	3,radiko
per	bersama	3,prepozicio
forta	kuat,kata akar	3,radiko
voĉo	suara,kata akar	3,radiko
okazi	laku,kata akar	3,radiko
scii	tahu,kata akar	3,radiko
letero	surat,kata akar	4,radiko
vera	benar,kata akar	4,radiko
foto	foto,kata akar	4,radiko
kiam	bila	4,tabelvorto
re	sekali lagi	4,prefikso
el	daripada	4,prepozicio
rapida	cepat,kata akar	4,radiko
tie	di sana	4,tabelvorto
stari	berdiri,kata akar	4,radiko
Vera	Vera	4,nomo
mano	tangan,kata akar	4,radiko
koleri	marah,kata akar	4,radiko
iĝ	menjadi (bukan dipaksakan)	4,sufikso
ruĝa	merah,kata akar	4,radiko
fali	menjatuh,kata akar	4,radiko
pardoni	maaf,kata akar	4,radiko
doni	memberi,kata akar	4,radiko
ricevi	menerima,kata akar	4,radiko
leciono	pelajaran,kata akar	4,radiko
plu	lagi	4,adverbo
os	Kata kerja menujukkan perbuatan akan datang	4,finaĵo
devi	mesti,kata akar	4,radiko
fermi	menutup,kata akar	4,radiko
pordo	pintu,kata akar	4,radiko
sinjoro	tuan,kata akar, Encik,kata akar	5,radiko
vendi	jual,kata akar	5,radiko
aŭto	kereta, kata akar	5,radiko
kiu	siapa	5,tabelvorto
plaĉi	merasa gembira,kata akar	5,radiko
demandi	bertanya,kata akar	5,radiko
plej	paling	5,adverbo
tiu	itu orang, itu barang	5,tabelvorto
ĉi	ini	5,partikulo
ĉiu	semua orang, semua	5,tabelvorto
pli	lebih	5,adverbo
ol	daripada	5,konjunkcio
tre	sangat	5,adverbo
certa	tentu,kata akar	5,radiko
kosti	harga,kata akar	5,radiko
bedaŭri	menyesal,kata akar	5,radiko
ind	bernilai	5,sufikso
aĉeti	membeli, kata akar	5,radiko
ĉar	kerana	5,konjunkcio
veturi	melancong,kata akar	5,radiko
dum	semasa	5,prepozicio
tio	itu	5,tabelvorto
edzo	suami,kata akar	5,radiko
Maja	Maja	6,nomo
et	kecil	6,sufikso
ul	orang	6,sufikso
tri	tiga	6,cifero
ig	menjadi sesuatu	6,sufikso
sana	sihat,kata akar	6,radiko
alta	tinggi, kata akar	6,radiko
temperaturo	suhu,kata akar	6,radiko
resti	tinggal,kata akar	6,radiko
morgaŭ	esok	6,adverbo
voki	pangil,kata akar	6,radiko
doktoro	doktor,kata akar	6,radiko
je	daripada, bersama, pada	6,prepozicio
naŭ	sembilan	6,cifero
horo	jam,kata akar	6,radiko
por	untuk	6,prepozicio
helpi	tolong,kata akar	6,radiko
montri	tunjuk,kata akar	6,radiko
piedo	kaki,kata akar	6,radiko
vesti	memakai,kata akar	6,radiko
ĉio	semua	6,tabelvorto
fine	akhirnya	6,vorto
semajno	minggu,kata akar	6,radiko
sub	di bawah	6,prepozicio
teo	teh,kata akar	6,radiko
mateno	pagi,kata akar	6,radiko
vespero	senja,kata akar	6,radiko
deziri	mengharap,kata akar	6,radiko
trankvila	tenang,kata akar	6,radiko
farti	merasa,kata akar	6,radiko
eg	besar, bertengkar	6,sufikso
Karlo	Karlo	6,nomo
hm	hm	6,interjekcio
dormi	tidur,kata akar	7,radiko
suno	matahari,kata akar	7,radiko
subita	tiba-tiba,kata akar	7,radiko
ek	mula satu perbuatan, tiba-tiba	7,prefikso
salti	lompat,kata akar	7,radiko
ĉiam	selalu	7,tabelvorto
frua	awal,kata akar	7,radiko
hodiaŭ	hari ini	7,adverbo
meti	letak,kata akar	7,radiko
aĵ	barang, manifestasi yang kekal	7,sufikso
kuri	lari,kata akar	7,radiko
laŭ	mengikut	7,prepozicio
homo	manusia,kata akar	7,radiko
kia	apa jenis	7,tabelvorto
saĝa	bijak,kata akar	7,radiko
knabo	lelaki kecil,kata akar	7,radiko
baldaŭ	tidak lama lagi	7,adverbo
it	imbuhan belakang untuk menjadikan kata kerja pasif menujukkan perbuatan telah berlalu	7,participo
nek	tidak	7,konjunkcio
pensi	fikir,kata akar	7,radiko
diablo	iblis,kata akar	7,radiko
memori	memori,kata akar	7,radiko
dimanĉo	hari Ahad,kata akar	7,radiko
raporti	lapor,kata akar	8,radiko
noto	nota,kata akar	8,radiko
aĉ	menujukkan yang tidak bagus	8,sufikso
kapo	kepala,kata akar	8,radiko
kiom	berapa	8,tabelvorto
da	daripada	8,prepozicio
ĉe	di	8,prepozicio
ludi	main,kata akar	8,radiko
mem	diri sendiri	8,partikulo
tiom	begitu banyak	8,tabelvorto
kvankam	walaupun	8,konjunkcio
tiam	masa itu	8,tabelvorto
aŭdi	mendengar, kata akar	8,radiko
vorto	perkataan,kata akar	8,radiko
tuj	segera	8,adverbo
respondi	jawab,kata akar	8,radiko
kara	sayang,kata akar	8,radiko
problemo	masalah,kata akar	8,radiko
pri	mengenai	8,prepozicio
muziko	muzik,kata akar	8,radiko
ridi	ketawa,kata akar	8,radiko
tamen	bagaimanapun	8,adverbo
Petro	Petro	9,nomo
Maria	Maria	9,nomo
vojaĝi	perjalanan,kata akar	9,radiko
lando	tanah,kata akar	9,radiko
libera	bebas,kata akar	9,radiko
tempo	masa,kata akar	9,radiko
decidi	memutus,kata akar	9,radiko
italio	Itali,kata akar	9,radiko
urbo	bandaraya,kata akar	9,radiko
feliĉa	gembira,kata akar	9,radiko
kie	di mana	9,tabelvorto
forgesi	lupa,kata akar	9,radiko
esperi	mengharap,kata akar	9,radiko
us	Kata kerja bersyarat	9,finaĵo
komenci	mula,kata akar	9,radiko
jam	sesudah	9,adverbo
vagono	gerabak,kata akar	9,radiko
ar	grup atau koleksi	9,sufikso
nenio	tidak ada apa-apa	9,tabelvorto
sekreto	rahsia,kata akar	9,radiko
onklo	pakcik,kata akar	9,radiko
Bonifacio	Bonifacio	9,nomo
plena	penuh,kata akar	9,radiko
um	makna tidak ditentukan	9,sufikso
sia	kata ganti refleksif,kata akar	9,radiko
uzi	guna,kata akar	9,radiko
domo	rumah,kata akar	9,radiko
ad	aksi berdarut	9,sufikso
atendi	menunggu, kata akar	9,radiko
do	begitu	9,adverbo
kial	kenapa	9,tabelvorto
neniam	tidak pernah	9,tabelvorto
kiel	begaimana	10,tabelvorto
pasi	lulus,kata akar	10,radiko
naski	melahirkan,kata akar	10,radiko
kelka	beberapa,kata akar	10,radiko
familio	famili,kata akar	10,radiko
an	ahli kumpulan	10,sufikso
iom	sehingga satu tahap, jumlah tertentu	10,tabelvorto
trovi	cari,kata akar	10,radiko
almenaŭ	sekurang-kurangnya	10,adverbo
ordo	pesan,kata akar	10,radiko
io	sesuatu	10,tabelvorto
manki	mengurangkan sesuatu,kata akar	10,radiko
lakto	susu,kata akar	10,radiko
necesa	perlu,kata akar	10,radiko
anstataŭ	bukannya	10,prepozicio
intereso	manarik minat,kata akar	10,radiko
ekskurso	melancong,kata akar	10,radiko
klubo	klub,kata akar	10,radiko
ĵeti	membuang,kata akar	10,radiko
ia	beberapa jenis	10,tabelvorto
uj	bekas, pokok, negara	10,sufikso
ĝusta	membetul,kata akar	10,radiko
for	pergi dari	10,prefikso
inter	antara	10,prepozicio
sama	sama,kata akar	10,radiko
fojo	masa,kata akar, kali,kata akar	10,radiko
rajti	hak,kata akar	10,radiko
proponi	cadang,kata akar	10,radiko
du	dua	10,cifero
parto	bahagian,kata akar	10,radiko
sukceso	berjaya,kata akar	10,radiko
iu	seseorang	10,tabelvorto
ideo		10,novaj
tro	terlalu banyak	10,adverbo
ec	kuali abstrak	10,sufikso
reala	benar,kata akar	10,radiko
silento	senyap,kata akar	10,radiko
daŭri	menyambung,kata akar	10,radiko
nu	ah	10,interjekcio
minuto	minit,kata akar	10,radiko
telefono	telefon,kata akar	10,radiko
viziti	lawat,kata akar	10,radiko
dolĉa	manis,kata akar	10,radiko
atenti	memberi perhatian, kata akar	10,radiko
dika	tebal,kata akar, gemuk,kata akar	10,radiko
ŝanĝi	tukar,kata akar	10,radiko
opinii	pendapat,kata akar	10,radiko
sen	tanpa	10,prepozicio
sola	bersendirian,kata akar	10,radiko
Veneci	Venice,kata akar	11,radiko
Sankt-Mark	Saint Marcus	11,nomo
placo	tempat,kata akar	11,radiko
milito	perang,kata akar	11,radiko
maro	laut,kata akar	11,radiko
ŝipo	kapal laut,kata akar	11,radiko
gondolo	gondola,kata akar	11,radiko
movi	gerak,kata akar	11,radiko
mezo	tengah,kata akar	11,radiko
proksima	dekat,kata akar	11,radiko
granda	besar,kata akar	11,radiko
oni	sesiapa	11,pronomo
facila	senang,kata akar	11,radiko
lumo	cahaya,kata akar	11,radiko
flanko	tepi,kata akar	11,radiko
Stefan	Stephen	11,nomo
krii	menjerit,kata akar	11,radiko
turko	Turki,kata akar	11,radiko
renkonti	jumpa,kata akar	11,radiko
sekvi	ikut,kata akar	11,radiko
Pietro	Pietro	11,nomo
koni	kenal,kata akar	11,radiko
akvo	air, kata akar	11,radiko
tiel	begini	11,tabelvorto
Ĝorĝo	George	11,nomo
preni	ambil,kata akar	11,radiko
estro	ketua	11,sufikso
preskaŭ	hampir	11,adverbo
morti	mati,kata akar	11,radiko
grava	penting,kata akar	11,radiko
Ĝino	Ĝino	11,nomo
halti	menghentikan,kata akar	11,radiko
apud	dekat	11,prepozicio
dek	sepuluh	11,cifero
jaro	tahun,kata akar	11,radiko
koloro	warna,kata akar	11,radiko
Jakopo	Yakop	11,nomo
tial	untuk alasan itu	11,tabelvorto
timi	takut,kata akar	11,radiko
sendi	hantar,kata akar	11,radiko
doĝo	doge,kata akar	11,radiko
bezoni	memerlu,kata akar	11,radiko
pagi	bayar,kata akar	11,radiko
er	serpihan, sebahagian kecil, partikle	11,sufikso
afero	perkara, kata akar	11,radiko
se	jika	11,konjunkcio
pano	roti,kata akar	11,radiko
Don Kamilo	Don Camillus	11,nomo
ĝis	hingga	11,prepozicio
S-ro	Sinjoro – Encik	12,mallongigo
Pipelbom	Pipelbom	12,nomo
peza	berat,kata akar	12,radiko
larĝa	lebar,kata akar	12,radiko
korpo	badan,kata akar	12,radiko
aspekto	kelihatan ,kata akar, aspek, kata akar	12,radiko
rolo	peranan,kata akar	12,radiko
fakto	fakta,kata akar	12,radiko
respekti	hormat,kata akar	12,radiko
kontenta	puas,kata akar	12,radiko
ofte	selalu,kata akar	12,radiko
utila	kegunaan,kata akar	12,radiko
prezenti	mempekenalkan,kata akar	12,radiko
ĝeni	kacau,kata akar	12,radiko
nokto	malam,kata akar	12,radiko
arbo	pokok, kata akar	12,radiko
ĉefo	ketua,kata akar	12,radiko
vojo	jalan,kata akar	12,radiko
ekster	di luar	12,prepozicio
sovaĝa	liar,kata akar	12,radiko
bruo	bunyian,kata akar	12,radiko
krom	di samping itu, sebagai tambhan kepada	12,prepozicio
tuŝi	sentuh,kata akar	12,radiko
naturo	alam semula jadi,kata akar	12,radiko
ĝenerali	umum,kata akar	12,radiko
seki	kering,kata akar	12,radiko
paŝi	langkah,kata akar	12,radiko
vivi	hidup,kata akar	12,radiko
dolori	sakit,kata akar, menyakiti,kata akar	12,radiko
agrabla	menyenangkan, kata akar	12,radiko
ju	lebih	12,partikulo
kastelo	istana,kata akar	12,radiko
des	lebih	12,partikulo
Adriano	Adriano	12,nomo
viro	lelaki,kata akar	12,radiko
kapabla	kebolehan,kata akar	12,radiko
industrio	industri,kata akar	12,radiko
polico	polis,kata akar	12,radiko
persono	orang,kata akar	12,radiko
simila	sama,kata akar	12,radiko
lasta	akhir,kata akar	12,radiko
laŭta	suara kuat,kata akar	12,radiko
orelo	telinga,kata akar	12,radiko
momento	masa,kata akar	12,radiko
ambaŭ	kedua-dua	12,adverbo
direkti	arah,kata akar	12,radiko
zorgi	penjagaan,kata akar	12,radiko
situacio	keadaan,kata akar	12,radiko
branĉo	cawangan,kata akar	12,radiko
rekta	terus,kata akar	12,radiko
besto	binatang,kata akar	12,radiko
promeni	bersiar-siar,kata akar	12,radiko
kavo	gua,kata akar	12,radiko
odoro	bau,kata akar	12,radiko
preta	sedia,kata akar	12,radiko
ajn	apa-apa	12,partikulo
efektiva	sebenar,kata akar	12,radiko
miri	hebat,kata akar	12,radiko
koro	hati,kata akar	12,radiko
ŝajni	kelihatan,kata akar	12,radiko
supri	di atas ,kata akar	12,radiko
buŝo	mulut,kata akar	12,radiko
provi	cuba,kata akar	12,radiko
kapti	menangkap,kata akar	12,radiko
lampo	lampu,kata akar,	12,radiko
paco	aman,kata akar	12,radiko
formo	menjadi,kata akar	12,radiko
teni	pegang,kata akar	12,radiko
sono	bunyi,kata akar	12,radiko
aŭtoritato	pihak berkuasa, kata akar	12,radiko
nuuuu	nuuuu	12,interjekcio
eee	eee	12,interjekcio
fuŝi	merosakkan,kata akar	12,radiko
klara	terang,kata akar	12,radiko
eĉ	walaupun	12,adverbo
tono	nada,kata akar	12,radiko
ha	ha	12,interjekcio
bieno	harta,kata akar	12,radiko
grafo	mengira,kata akar	12,radiko
monto	gunung,kata akar	12,radiko
kalva	botak,kata akar	12,radiko
inviti	mengundang,kata akar	12,radiko
peti	minta,kata akar	12,radiko
teroro	keganasan,kata akar	12,radiko
kontroli	semak,kata akar	12,radiko
ĉirkaŭ	sekitar	12,prepozicio
akcepti	terima, kata akar	12,radiko
perdi	hilang,kata akar	12,radiko
