Marko	Marko	1,nomo
esti	være	1,radiko
as	Verbum præsens / Udsagsnord i nutid	1,finaĵo
mi	jeg	1,pronomo
a	Adjektiv / Tillægsord	1,finaĵo
amiko	ven	1,radiko
o	Substantiv / Navneord	1,finaĵo
li	han	1,pronomo
lerni	lære	1,radiko
ant	nutid aktiv	1,participo
kaj	og	1,konjunkcio
sporto	sport	1,radiko
ist	profession, stærk hobbyist	1,sufikso
nun	nu	1,adverbo
sidi	sidde	1,radiko
en	i	1,prepozicio
ĉambro	værelse, rum	1,radiko
sur	på	1,prepozicio
tablo	bord	1,radiko
papero	papir	1,radiko
j	Pluralis / Flertal	1,finaĵo
libro	bog	1,radiko
ĝi	den, det	1,pronomo
skribi	skrive	1,radiko
la	den, det	1,artikolo
patro	far	1,radiko
in	kvindelig	1,sufikso
de	af, fra	1,prepozicio
ne	nej, ikke	1,partikulo
ili	de	1,pronomo
labori	arbejde	1,radiko
hotelo	hotel	1,radiko
instrui	lære, undervise	1,radiko
ŝi	hun	1,pronomo
havi	have	2,radiko
n	Akkusativ	2,finaĵo
nomo	navn	2,radiko
Ana	Ana	2,nomo
juna	ung	2,radiko
bela	smuk	2,radiko
ge	af flere køn	2,prefikso
veni	komme	2,radiko
is	Verbum præterium / Udsagsnord i datid	2,finaĵo
al	til, i retning af	2,prepozicio
hejmo	hjem	2,radiko
bona	god	2,radiko
voli	ville	2,radiko
u	Verbum imperativ / Udsagnsord i bydeform	2,finaĵo
iri	tage til	2,radiko
i	Infinitiv / Navneform	2,finaĵo
saluto	hej	2,radiko
kio	hvad	2,tabelvorto
vi	du, I	2,pronomo
fari	gøre, lave	2,radiko
legi	læse	2,radiko
sed	men	2,konjunkcio
paroli	tale	2,radiko
kun	med	2,prepozicio
ĉu	(starter spørgsmål), om, hvorvidt	2,partikulo
jes	ja	2,adverbo
ŝati	kunne lide	2,radiko
nur	kun	2,adverbo
trinki	drikke	2,radiko
kafo	kaffe	2,radiko
frato	bror	2,radiko
jen	her er, værsågod	2,partikulo
ankoraŭ	stadig, endnu	2,adverbo
varma	varm	2,radiko
kuiri	tilberede mad, lave mad	2,radiko
danki	takke	2,radiko
povi	kunne	2,radiko
ankaŭ	også	2,adverbo
mal	modsat	2,prefikso
rigardi	kigge på	2,radiko
okulo	øje	2,radiko
vidi	se	2,radiko
ke	at	2,konjunkcio
ami	kærlighed	2,radiko
longa	lang	3,radiko
e	Adverbium / Biord	3,finaĵo
antaŭ	før, foran	3,prepozicio
ej	sted	3,sufikso
post	efter	3,prepozicio
ĝoja	glædelig	3,radiko
tra	gennem	3,prepozicio
strato	gade	3,radiko
tago	dag	3,radiko
kuko	kage	3,radiko
ni	vi	3,pronomo
manĝi	spise	3,radiko
diri	sige	3,radiko
sufiĉa	nok	3,radiko
mono	penge	3,radiko
kompreni	forstå	3,radiko
ebl	mulighed	3,sufikso
cent	hundrede	3,cifero
dolaro	dollar	3,radiko
ho	oh	3,interjekcio
riĉa	rig	3,radiko
kelnero	tjener	3,radiko
porti	bære	3,radiko
multa	mange	3,radiko
nova	ny	3,radiko
serĉi	søge	3,radiko
unu	én, ét, en, et	3,cifero
loko	sted	3,radiko
alia	anden	3,radiko
vizaĝo	ansigt	3,radiko
fini	færdiggøre	3,radiko
per	ved, per, med	3,prepozicio
forta	stærk	3,radiko
voĉo	stemme	3,radiko
okazi	ske	3,radiko
scii	vide	3,radiko
letero	brev	4,radiko
vera	sand	4,radiko
foto	foto	4,radiko
kiam	hvornår	4,tabelvorto
re	igen, gen-	4,prefikso
el	fra, ud af, af	4,prepozicio
rapida	hurtig	4,radiko
tie	der	4,tabelvorto
stari	stå	4,radiko
Vera	Vera	4,nomo
mano	hånd	4,radiko
koleri	vrede	4,radiko
iĝ	blive, forblive	4,sufikso
ruĝa	rød	4,radiko
fali	falde	4,radiko
pardoni	tilgive, undskylde	4,radiko
doni	give	4,radiko
ricevi	modtage	4,radiko
leciono	lektion	4,radiko
plu	endnu	4,adverbo
os	Verbum futurum / Udsagsnord i fremtid	4,finaĵo
devi	skulle, være nødt til	4,radiko
fermi	lukke	4,radiko
pordo	dør	4,radiko
sinjoro	herre, Hr	5,radiko
vendi	sælge	5,radiko
aŭto	bil	5,radiko
kiu	hvem, hvilken	5,tabelvorto
plaĉi	tilfredsstille	5,radiko
demandi	spørge	5,radiko
plej	mest (superlativ)	5,adverbo
tiu	den person, den der	5,tabelvorto
ĉi	denne	5,partikulo
ĉiu	alle, hver	5,tabelvorto
pli	mere (komparativ)	5,adverbo
ol	end	5,konjunkcio
tre	meget	5,adverbo
certa	sikker	5,radiko
kosti	koste	5,radiko
bedaŭri	beklage, fortryde	5,radiko
ind	værdig af	5,sufikso
aĉeti	købe	5,radiko
ĉar	fordi, for	5,konjunkcio
veturi	rejse	5,radiko
dum	under, undervejs, mens	5,prepozicio
tio	den	5,tabelvorto
edzo	mand, ægtemand	5,radiko
Maja	Maja	6,nomo
et	lille, diminutiv	6,sufikso
ul	person	6,sufikso
tri	tre	6,cifero
ig	forårsage noget	6,sufikso
sana	rask	6,radiko
alta	høj	6,radiko
temperaturo	temperatur	6,radiko
resti	blive	6,radiko
morgaŭ	i morgen	6,adverbo
voki	ringe	6,radiko
doktoro	doktor	6,radiko
je	af, med, i	6,prepozicio
naŭ	ni	6,cifero
horo	time, klokken	6,radiko
por	for	6,prepozicio
helpi	hjælpe	6,radiko
montri	vise	6,radiko
piedo	fod	6,radiko
vesti	have på	6,radiko
ĉio	alt	6,tabelvorto
fine	til sidst	6,vorto
semajno	uge	6,radiko
sub	under, nedenunder	6,prepozicio
teo	te	6,radiko
mateno	morgen	6,radiko
vespero	aften	6,radiko
deziri	ønske	6,radiko
trankvila	rolig	6,radiko
farti	have det, føle sig	6,radiko
eg	stor, augmentativ	6,sufikso
Karlo	Karlo	6,nomo
hm	hm	6,interjekcio
dormi	sove	7,radiko
suno	sol	7,radiko
subita	pludselig	7,radiko
ek	begyndelse af handling, pludselighed	7,prefikso
salti	hoppe	7,radiko
ĉiam	altid	7,tabelvorto
frua	tidlig	7,radiko
hodiaŭ	i dag	7,adverbo
meti	lægge	7,radiko
aĵ	ting, konkret manifestation	7,sufikso
kuri	løbe	7,radiko
laŭ	langs, ifølge	7,prepozicio
homo	menneske	7,radiko
kia	hvilken slags	7,tabelvorto
saĝa	vis	7,radiko
knabo	dreng	7,radiko
baldaŭ	snart	7,adverbo
it	datid passiv	7,participo
nek	hverken (… eller)	7,konjunkcio
pensi	tænke	7,radiko
diablo	djævel	7,radiko
memori	huske	7,radiko
dimanĉo	søndag	7,radiko
raporti	anmelde	8,radiko
noto	note	8,radiko
aĉ	ubehagelig, dårlig, ringe	8,sufikso
kapo	hoved	8,radiko
kiom	hvor meget	8,tabelvorto
da	af	8,prepozicio
ĉe	ved, hos	8,prepozicio
ludi	lege	8,radiko
mem	selv	8,partikulo
tiom	så meget	8,tabelvorto
kvankam	selvom	8,konjunkcio
tiam	på det tidspunkt	8,tabelvorto
aŭdi	høre	8,radiko
vorto	ord	8,radiko
tuj	med det samme	8,adverbo
respondi	besvare	8,radiko
kara	kære	8,radiko
problemo	problem	8,radiko
pri	om, vedrørende	8,prepozicio
muziko	musik	8,radiko
ridi	grine	8,radiko
tamen	men, dog, imidlertid	8,adverbo
Petro	Petro	9,nomo
Maria	Maria	9,nomo
vojaĝi	rejse	9,radiko
lando	land	9,radiko
libera	gratis	9,radiko
tempo	tid	9,radiko
decidi	bestemme, tage beslutning, afgøre	9,radiko
italio	Italien	9,radiko
urbo	by	9,radiko
feliĉa	lykkelig	9,radiko
kie	hvor	9,tabelvorto
forgesi	glemme	9,radiko
esperi	håbe	9,radiko
us	Verbum konditional / Betinget udsagnsord	9,finaĵo
komenci	begynde	9,radiko
jam	allerede	9,adverbo
vagono	vogn	9,radiko
ar	gruppe, samling, sæt	9,sufikso
nenio	intet	9,tabelvorto
sekreto	hemmelighed	9,radiko
onklo	onkel	9,radiko
Bonifacio	Bonifacio	9,nomo
plena	fuld	9,radiko
um	ubestemt betydning	9,sufikso
sia	sig	9,radiko
uzi	bruge	9,radiko
domo	hus	9,radiko
ad	fortsat handling	9,sufikso
atendi	vente, forvente	9,radiko
do	så	9,adverbo
kial	hvorfor	9,tabelvorto
neniam	aldrig	9,tabelvorto
kiel	hvordan	10,tabelvorto
pasi	lade	10,radiko
naski	føde	10,radiko
kelka	smule, nogen	10,radiko
familio	familie	10,radiko
an	medlem af en gruppe	10,sufikso
iom	en hvis mængde	10,tabelvorto
trovi	finde	10,radiko
almenaŭ	i det mindste	10,adverbo
ordo	bestille	10,radiko
io	noget	10,tabelvorto
manki	mangle	10,radiko
lakto	mælk	10,radiko
necesa	behøve, have brug for	10,radiko
anstataŭ	i stedet for	10,prepozicio
intereso	interessere	10,radiko
ekskurso	ekskursion	10,radiko
klubo	klub	10,radiko
ĵeti	kaste	10,radiko
ia	en slags	10,tabelvorto
uj	beholder, træ, land	10,sufikso
ĝusta	korrekt	10,radiko
for	væk, fra	10,prefikso
inter	mellem, blandt	10,prepozicio
sama	samme	10,radiko
fojo	gang, tilfælde	10,radiko
rajti	måtte	10,radiko
proponi	foreslå	10,radiko
du	to	10,cifero
parto	part, del	10,radiko
sukceso	succes	10,radiko
iu	nogen	10,tabelvorto
ideo	idé, ide	10,novaj
tro	for, for meget	10,adverbo
ec	abstrakt kvalitet	10,sufikso
reala	rigtig	10,radiko
silento	stille	10,radiko
daŭri	fortsætte	10,radiko
nu	altså	10,interjekcio
minuto	minut	10,radiko
telefono	telefon	10,radiko
viziti	besøge	10,radiko
dolĉa	sød	10,radiko
atenti	være opmærksom	10,radiko
dika	tyk, fed	10,radiko
ŝanĝi	ændre	10,radiko
opinii	holdning	10,radiko
sen	uden	10,prepozicio
sola	alene	10,radiko
Veneci	Venedig	11,radiko
Sankt-Mark	Johannes Markus	11,nomo
placo	plads	11,radiko
milito	krig	11,radiko
maro	hav	11,radiko
ŝipo	skib	11,radiko
gondolo	gondol	11,radiko
movi	bevæge, flytte	11,radiko
mezo	midte	11,radiko
proksima	nær	11,radiko
granda	stor	11,radiko
oni	man	11,pronomo
facila	nem	11,radiko
lumo	let	11,radiko
flanko	side	11,radiko
Stefan	Stephen	11,nomo
krii	skrige	11,radiko
turko	tyrkisk	11,radiko
renkonti	møde	11,radiko
sekvi	følge	11,radiko
Pietro	Pietro	11,nomo
koni	kende	11,radiko
akvo	vand	11,radiko
tiel	sådan	11,tabelvorto
Ĝorĝo	Georg	11,nomo
preni	tage	11,radiko
estro	chef, leder	11,sufikso
preskaŭ	næsten	11,adverbo
morti	dø	11,radiko
grava	vigtig	11,radiko
Ĝino	Ĝino	11,nomo
halti	stoppe	11,radiko
apud	ved siden af	11,prepozicio
dek	ti	11,cifero
jaro	år	11,radiko
koloro	farve	11,radiko
Jakopo	Jacob	11,nomo
tial	derfor	11,tabelvorto
timi	frygt	11,radiko
sendi	sende	11,radiko
doĝo	doge	11,radiko
bezoni	behøve, have brug for	11,radiko
pagi	betale	11,radiko
er	fragment, del af homogen helhed, partikel	11,sufikso
afero	ting	11,radiko
se	hvis	11,konjunkcio
pano	brød	11,radiko
Don Kamilo	Don Camillus	11,nomo
ĝis	indtil	11,prepozicio
S-ro	Hr	12,mallongigo
Pipelbom	Pipelbom	12,nomo
peza	tung	12,radiko
larĝa	bred	12,radiko
korpo	krop	12,radiko
aspekto	se ud som, virke	12,radiko
rolo	rolle	12,radiko
fakto	faktum	12,radiko
respekti	respektere	12,radiko
kontenta	tilfreds	12,radiko
ofte	ofte	12,radiko
utila	brugbar	12,radiko
prezenti	præsentere	12,radiko
ĝeni	forstyrre, irritere	12,radiko
nokto	nat	12,radiko
arbo	træ	12,radiko
ĉefo	chef	12,radiko
vojo	vej	12,radiko
ekster	undenfor	12,prepozicio
sovaĝa	vild	12,radiko
bruo	støj	12,radiko
krom	i øvrigt, bortset, undtagen	12,prepozicio
tuŝi	røre	12,radiko
naturo	natur	12,radiko
ĝenerali	generelt	12,radiko
seki	tør	12,radiko
paŝi	skridt	12,radiko
vivi	leve	12,radiko
dolori	smerte, skade	12,radiko
agrabla	behagelig	12,radiko
ju	jo (flere, mere, mindre)	12,partikulo
kastelo	slot	12,radiko
des	des (flere, mere, mindre)	12,partikulo
Adriano	Adriano	12,nomo
viro	mand	12,radiko
kapabla	i stand til, egnet	12,radiko
industrio	industri	12,radiko
polico	politi	12,radiko
persono	person	12,radiko
simila	lignende	12,radiko
lasta	sidste	12,radiko
laŭta	højlydt	12,radiko
orelo	øre	12,radiko
momento	øjeblik	12,radiko
ambaŭ	begge	12,adverbo
direkti	retning	12,radiko
zorgi	tage sig af	12,radiko
situacio	situation	12,radiko
branĉo	gren	12,radiko
rekta	direkte	12,radiko
besto	dyr	12,radiko
promeni	slentre	12,radiko
kavo	hule	12,radiko
odoro	lugt	12,radiko
preta	være klar	12,radiko
ajn	som helst	12,partikulo
efektiva	faktisk	12,radiko
miri	spekulere	12,radiko
koro	hjerte	12,radiko
ŝajni	virke	12,radiko
supri	over	12,radiko
buŝo	mund	12,radiko
provi	prøve	12,radiko
kapti	fange	12,radiko
lampo	lampe	12,radiko
paco	sted	12,radiko
formo	form	12,radiko
teni	hold	12,radiko
sono	lyde	12,radiko
aŭtoritato	autoritet	12,radiko
nuuuu	altsååå	12,interjekcio
eee	eh, æh, æhh	12,interjekcio
fuŝi	sjuske	12,radiko
klara	klar, ikke tåget	12,radiko
eĉ	selv, endda	12,adverbo
tono	tone	12,radiko
ha	ah	12,interjekcio
bieno	grund, land	12,radiko
grafo	greve	12,radiko
monto	bjerg	12,radiko
kalva	skaldet	12,radiko
inviti	invitere	12,radiko
peti	anmode	12,radiko
teroro	terror	12,radiko
kontroli	kontrollere, tjekke	12,radiko
ĉirkaŭ	omkring	12,prepozicio
akcepti	akceptere	12,radiko
perdi	miste	12,radiko
