Marko	Marko	1,nomo
esti	sein (Verb, Wortstamm)	1,radiko
as	Endung für Verb in der Gegenwart	1,finaĵo
mi	ich	1,pronomo
a	Adjektiv-Endung	1,finaĵo
amiko	Freund	1,radiko
o	Substantiv-Endung	1,finaĵo
li	er	1,pronomo
lerni	lernen	1,radiko
ant	Aktiv-Partizip / Verlaufsform, Gegenwart	1,participo
kaj	und	1,konjunkcio
sporto	Sport	1,radiko
ist	Beruf, Weltanschauung	1,sufikso
nun	nun, jetzt	1,adverbo
sidi	sitzen	1,radiko
en	in	1,prepozicio
ĉambro	Zimmer	1,radiko
sur	auf	1,prepozicio
tablo	Tisch	1,radiko
papero	Papier	1,radiko
j	Mehrzahl-Endung	1,finaĵo
libro	Buch	1,radiko
ĝi	es	1,pronomo
skribi	schreiben	1,radiko
la	der, die, das	1,artikolo
patro	Vater	1,radiko
in	weiblich	1,sufikso
de	von	1,prepozicio
ne	nein, nicht	1,partikulo
ili	sie (Mehrzahl)	1,pronomo
labori	arbeiten	1,radiko
hotelo	Hotel	1,radiko
instrui	unterrichten	1,radiko
ŝi	sie	1,pronomo
havi	haben	2,radiko
n	Akkusativ-Endung	2,finaĵo
nomo	Name	2,radiko
Ana	Ana	2,nomo
juna	jung	2,radiko
bela	schön	2,radiko
ge	Personen beiderlei Geschlechts	2,prefikso
veni	kommen	2,radiko
is	Endung für Verb in der Vergangenheit	2,finaĵo
al	nach, zu	2,prepozicio
hejmo	Heim, Zuhause	2,radiko
bona	gut	2,radiko
voli	wollen	2,radiko
u	Endung für Verb im Imperativ	2,finaĵo
iri	gehen	2,radiko
i	Infinitiv-Endung	2,finaĵo
saluto	Gruß	2,radiko
kio	was	2,tabelvorto
vi	du	2,pronomo
fari	machen, tun	2,radiko
legi	lesen	2,radiko
sed	aber	2,konjunkcio
paroli	sprechen	2,radiko
kun	mit	2,prepozicio
ĉu	ob; kennzeichnet auch einfache Fragesätze	2,partikulo
jes	ja	2,adverbo
ŝati	mögen, gern haben	2,radiko
nur	nur, bloß	2,adverbo
trinki	trinken	2,radiko
kafo	Kaffee	2,radiko
frato	Bruder	2,radiko
jen	da ist	2,partikulo
ankoraŭ	noch	2,adverbo
varma	warm	2,radiko
kuiri	kochen	2,radiko
danki	Dank	2,radiko
povi	können	2,radiko
ankaŭ	auch	2,adverbo
mal	Gegenteil	2,prefikso
rigardi	schauen	2,radiko
okulo	Auge	2,radiko
vidi	sehen	2,radiko
ke	dass	2,konjunkcio
ami	lieben	2,radiko
longa	lange	3,radiko
e	Adverb-Endung	3,finaĵo
antaŭ	vor	3,prepozicio
ej	Ort, Raum, Stelle	3,sufikso
post	nach	3,prepozicio
ĝoja	froh	3,radiko
tra	durch	3,prepozicio
strato	Straße	3,radiko
tago	Tag	3,radiko
kuko	Kuchen	3,radiko
ni	wir	3,pronomo
manĝi	essen	3,radiko
diri	sagen	3,radiko
sufiĉa	genügend	3,radiko
mono	Geld	3,radiko
kompreni	verstehen	3,radiko
ebl	Möglichkeit (-bar)	3,sufikso
cent	hundert	3,cifero
dolaro	Dollar	3,radiko
ho	oh	3,interjekcio
riĉa	reich	3,radiko
kelnero	Kelner	3,radiko
porti	tragen	3,radiko
multa	viel	3,radiko
nova	neu	3,radiko
serĉi	suchen	3,radiko
unu	ein, eine, eines, eins	3,cifero
loko	Ort	3,radiko
alia	anderer	3,radiko
vizaĝo	Gesicht	3,radiko
fini	Ende	3,radiko
per	mit, mittels	3,prepozicio
forta	stark	3,radiko
voĉo	Stimme	3,radiko
okazi	geschehen	3,radiko
scii	wissen	3,radiko
letero	Brief	4,radiko
vera	wahr	4,radiko
foto	Foto	4,radiko
kiam	wann	4,tabelvorto
re	wieder-, zurück-	4,prefikso
el	aus	4,prepozicio
rapida	schnell	4,radiko
tie	dort	4,tabelvorto
stari	stehen	4,radiko
Vera	Vera	4,nomo
mano	Hand	4,radiko
koleri	zürnen, zornig sein	4,radiko
iĝ	werden	4,sufikso
ruĝa	rot	4,radiko
fali	fallen	4,radiko
pardoni	verzeihen	4,radiko
doni	geben	4,radiko
ricevi	bekommen	4,radiko
leciono	Lektion	4,radiko
plu	mehr, weiterhin	4,adverbo
os	Endung für Verb in der Zukunft	4,finaĵo
devi	müssen	4,radiko
fermi	schließen	4,radiko
pordo	Tür	4,radiko
sinjoro	Herr	5,radiko
vendi	verkaufen	5,radiko
aŭto	Auto	5,radiko
kiu	wer, welcher	5,tabelvorto
plaĉi	gefallen	5,radiko
demandi	fragen	5,radiko
plej	meist (Superlativ)	5,adverbo
tiu	jener	5,tabelvorto
ĉi	näher liegend	5,partikulo
ĉiu	jeder	5,tabelvorto
pli	mehr (Komparativ)	5,adverbo
ol	als	5,konjunkcio
tre	sehr	5,adverbo
certa	sicher(lich)	5,radiko
kosti	kosten	5,radiko
bedaŭri	bedauern	5,radiko
ind	-wert, -würdig	5,sufikso
aĉeti	kaufen	5,radiko
ĉar	weil, denn	5,konjunkcio
veturi	fahren	5,radiko
dum	während	5,prepozicio
tio	jenes, das	5,tabelvorto
edzo	Gatte	5,radiko
Maja	Maja	6,nomo
et	Verkleinerung	6,sufikso
ul	Person	6,sufikso
tri	drei	6,cifero
ig	machen	6,sufikso
sana	gesund	6,radiko
alta	hoch	6,radiko
temperaturo	Temperatur	6,radiko
resti	bleiben	6,radiko
morgaŭ	morgen	6,adverbo
voki	rufen	6,radiko
doktoro	Doktor	6,radiko
je	Verhältniswort mit mehreren Bedeutungen	6,prepozicio
naŭ	neun	6,cifero
horo	Stunde	6,radiko
por	für	6,prepozicio
helpi	helfen	6,radiko
montri	zeigen	6,radiko
piedo	Fuß	6,radiko
vesti	kleiden	6,radiko
ĉio	alles	6,tabelvorto
fine	endlich, schließlich	6,vorto
semajno	Woche	6,radiko
sub	unter	6,prepozicio
teo	Tee	6,radiko
mateno	Morgen	6,radiko
vespero	Abend	6,radiko
deziri	wünschen	6,radiko
trankvila	ruhig	6,radiko
farti	sich fühlen	6,radiko
eg	Vergrößerung	6,sufikso
Karlo	Karlo	6,nomo
hm	hm	6,interjekcio
dormi	schlafen	7,radiko
suno	Sonne	7,radiko
subita	plötzlich	7,radiko
ek	beginnende Handlung	7,prefikso
salti	springen	7,radiko
ĉiam	immer	7,tabelvorto
frua	früh	7,radiko
hodiaŭ	heute	7,adverbo
meti	setzen, stellen, legen	7,radiko
aĵ	konkrete Sache	7,sufikso
kuri	laufen	7,radiko
laŭ	gemäß	7,prepozicio
homo	Mensch	7,radiko
kia	was für ein	7,tabelvorto
saĝa	klug, weise	7,radiko
knabo	Knabe	7,radiko
baldaŭ	bald	7,adverbo
it	Passiv-Partizip / Verlaufsform, Vergangenheit	7,participo
nek	weder (… noch)	7,konjunkcio
pensi	denken	7,radiko
diablo	Teufel	7,radiko
memori	sich erinnern	7,radiko
dimanĉo	Sonntag	7,radiko
raporti	berichten	8,radiko
noto	Note, Notiz	8,radiko
aĉ	äußere Verschlechterung	8,sufikso
kapo	Kopf	8,radiko
kiom	wieviel	8,tabelvorto
da	von (Menge)	8,prepozicio
ĉe	bei	8,prepozicio
ludi	spielen	8,radiko
mem	selbst	8,partikulo
tiom	soviel	8,tabelvorto
kvankam	obwohl	8,konjunkcio
tiam	dann	8,tabelvorto
aŭdi	hören	8,radiko
vorto	Wort	8,radiko
tuj	sofort	8,adverbo
respondi	antworten	8,radiko
kara	lieb, teuer, wert	8,radiko
problemo	Problem	8,radiko
pri	über	8,prepozicio
muziko	Musik	8,radiko
ridi	lachen	8,radiko
tamen	dennoch	8,adverbo
Petro	Petro	9,nomo
Maria	Maria	9,nomo
vojaĝi	reisen	9,radiko
lando	Land	9,radiko
libera	frei	9,radiko
tempo	Zeit	9,radiko
decidi	entscheiden	9,radiko
italio	Italien	9,radiko
urbo	Stadt	9,radiko
feliĉa	glücklich	9,radiko
kie	wo	9,tabelvorto
forgesi	vergessen	9,radiko
esperi	hoffen	9,radiko
us	Endung für Verb im Konditional	9,finaĵo
komenci	anfangen	9,radiko
jam	schon	9,adverbo
vagono	Waggon	9,radiko
ar	Sammelbegriff	9,sufikso
nenio	nichts	9,tabelvorto
sekreto	Geheimnis	9,radiko
onklo	Onkel	9,radiko
Bonifacio	Bonifacio	9,nomo
plena	voll	9,radiko
um	ohne bestimmte Bedeutung (Joker)	9,sufikso
sia	sein/ihr	9,radiko
uzi	gebrauchen	9,radiko
domo	Haus	9,radiko
ad	Dauer	9,sufikso
atendi	warten	9,radiko
do	also	9,adverbo
kial	warum	9,tabelvorto
neniam	nie	9,tabelvorto
kiel	wie	10,tabelvorto
pasi	vorbei gehen	10,radiko
naski	gebären	10,radiko
kelka	manch, einige	10,radiko
familio	Familie	10,radiko
an	Mitglied, Anhänger	10,sufikso
iom	etwas, ein wenig	10,tabelvorto
trovi	finden	10,radiko
almenaŭ	wenigstens	10,adverbo
ordo	Ordnung	10,radiko
io	irgendwas	10,tabelvorto
manki	fehlen	10,radiko
lakto	Milch	10,radiko
necesa	notwendig	10,radiko
anstataŭ	anstatt	10,prepozicio
intereso	Interesse	10,radiko
ekskurso	Ausflug	10,radiko
klubo	Club	10,radiko
ĵeti	werfen	10,radiko
ia	irgendein	10,tabelvorto
uj	Behälter, Land, Baum	10,sufikso
ĝusta	richtig	10,radiko
for	fort-, weg-, ab-	10,prefikso
inter	zwischen	10,prepozicio
sama	gleich	10,radiko
fojo	Mal	10,radiko
rajti	das Recht haben, dürfen	10,radiko
proponi	vorschlagen	10,radiko
du	zwei	10,cifero
parto	Teil	10,radiko
sukceso	Erfolg haben	10,radiko
iu	jemand	10,tabelvorto
ideo	Idee	10,novaj
tro	allzu	10,adverbo
ec	abstrakter Begriff (-keit)	10,sufikso
reala	wirklich	10,radiko
silento	Schweigen	10,radiko
daŭri	dauern	10,radiko
nu	na	10,interjekcio
minuto	Minute	10,radiko
telefono	Telefon	10,radiko
viziti	besuchen	10,radiko
dolĉa	süß	10,radiko
atenti	acht geben	10,radiko
dika	dick	10,radiko
ŝanĝi	wechseln	10,radiko
opinii	meinen	10,radiko
sen	ohne	10,prepozicio
sola	allein	10,radiko
Veneci	Venedig	11,radiko
Sankt-Mark	Sankt-Markus	11,nomo
placo	Platz	11,radiko
milito	Krieg	11,radiko
maro	Meer	11,radiko
ŝipo	Schiff	11,radiko
gondolo	Gondel	11,radiko
movi	bewegen	11,radiko
mezo	Mitte	11,radiko
proksima	nahe	11,radiko
granda	groß	11,radiko
oni	man	11,pronomo
facila	leicht	11,radiko
lumo	Licht	11,radiko
flanko	Seite	11,radiko
Stefan	Stephen	11,nomo
krii	schreien	11,radiko
turko	Türke	11,radiko
renkonti	begegnen	11,radiko
sekvi	folgen	11,radiko
Pietro	Pietro	11,nomo
koni	kennen	11,radiko
akvo	Wasser	11,radiko
tiel	so	11,tabelvorto
Ĝorĝo	George	11,nomo
preni	nehmen	11,radiko
estro	Leiter, Chef, Vorstand	11,sufikso
preskaŭ	fast	11,adverbo
morti	sterben	11,radiko
grava	wichtig	11,radiko
Ĝino	Ĝino	11,nomo
halti	anhalten	11,radiko
apud	neben	11,prepozicio
dek	zehn	11,cifero
jaro	Jahr	11,radiko
koloro	Farbe	11,radiko
Jakopo	Jacob	11,nomo
tial	deshalb	11,tabelvorto
timi	fürchten	11,radiko
sendi	schicken	11,radiko
doĝo	Doge (Oberhaupt)	11,radiko
bezoni	brauchen, benötigen	11,radiko
pagi	zahlen	11,radiko
er	Fragment, Stück von	11,sufikso
afero	Angelegenheit, Sache	11,radiko
se	wenn	11,konjunkcio
pano	Brot	11,radiko
Don Kamilo	Don Camillus	11,nomo
ĝis	bis	11,prepozicio
S-ro	Sinjoro – Herr	12,mallongigo
Pipelbom	Pipelbom	12,nomo
peza	schwer	12,radiko
larĝa	breit	12,radiko
korpo	Körper	12,radiko
aspekto	aussehen	12,radiko
rolo	Rolle	12,radiko
fakto	tatsächlich	12,radiko
respekti	achten	12,radiko
kontenta	zufrieden	12,radiko
ofte	oft	12,radiko
utila	nützlich	12,radiko
prezenti	vorstellen	12,radiko
ĝeni	stören, belästigen	12,radiko
nokto	Nacht	12,radiko
arbo	Baum	12,radiko
ĉefo	Chef	12,radiko
vojo	Weg	12,radiko
ekster	außerhalb	12,prepozicio
sovaĝa	wild	12,radiko
bruo	Lärm	12,radiko
krom	außer	12,prepozicio
tuŝi	berühren	12,radiko
naturo	Natur	12,radiko
ĝenerali	allgemein	12,radiko
seki	trocken	12,radiko
paŝi	schreiten	12,radiko
vivi	leben	12,radiko
dolori	Schmerz	12,radiko
agrabla	angenehm	12,radiko
ju	je (… desto)	12,partikulo
kastelo	Schloss, Kastell	12,radiko
des	(je …) desto	12,partikulo
Adriano	Adriano	12,nomo
viro	Mann	12,radiko
kapabla	fähig	12,radiko
industrio	Industrie	12,radiko
polico	Polizei	12,radiko
persono	Person	12,radiko
simila	ähnlich	12,radiko
lasta	letzter	12,radiko
laŭta	laut	12,radiko
orelo	Ohr	12,radiko
momento	Moment	12,radiko
ambaŭ	beide	12,adverbo
direkti	Richtung	12,radiko
zorgi	sorgen	12,radiko
situacio	Lage	12,radiko
branĉo	Zweig, Ast	12,radiko
rekta	direkt	12,radiko
besto	Tier	12,radiko
promeni	spazierengehen	12,radiko
kavo	Höhle, Grube	12,radiko
odoro	Duft	12,radiko
preta	bereit	12,radiko
ajn	überhaupt, auch immer, auch nur	12,partikulo
efektiva	wirklich, tatsächlich	12,radiko
miri	sich wundern	12,radiko
koro	Herz	12,radiko
ŝajni	scheinen	12,radiko
supri	oben	12,radiko
buŝo	Mund	12,radiko
provi	versuchen	12,radiko
kapti	fangen	12,radiko
lampo	Lampe	12,radiko
paco	Friede	12,radiko
formo	Form	12,radiko
teni	halten	12,radiko
sono	Klang	12,radiko
aŭtoritato	Autorität	12,radiko
nuuuu	nuuuu	12,interjekcio
eee	eee	12,interjekcio
fuŝi	pfuschen	12,radiko
klara	klar	12,radiko
eĉ	sogar, selbst	12,adverbo
tono	Ton	12,radiko
ha	ha	12,interjekcio
bieno	Landgut, Bauerngut	12,radiko
grafo	Graf	12,radiko
monto	Berg	12,radiko
kalva	kahl	12,radiko
inviti	einladen	12,radiko
peti	bitten	12,radiko
teroro	Terror	12,radiko
kontroli	prüfen	12,radiko
ĉirkaŭ	um, herum	12,prepozicio
akcepti	akzeptieren	12,radiko
perdi	verlieren	12,radiko
