Marko	Marc	1,nomo
esti	ser, estar, haver-hi	1,radiko
as	verb en present	1,finaĵo
mi	jo	1,pronomo
a	adjectiu	1,finaĵo
amiko	amic	1,radiko
o	substantiu	1,finaĵo
li	ell	1,pronomo
lerni	aprendre	1,radiko
ant	present actiu	1,participo
kaj	i	1,konjunkcio
sporto	esport	1,radiko
ist	professió, activitat característica	1,sufikso
nun	ara	1,adverbo
sidi	estar assegut, seure	1,radiko
en	a, en	1,prepozicio
ĉambro	habitació	1,radiko
sur	damunt, sobre	1,prepozicio
tablo	taula	1,radiko
papero	paper	1,radiko
j	plural	1,finaĵo
libro	llibre	1,radiko
ĝi	(pronom per a animals i coses, sense distingir sexe)	1,pronomo
skribi	escriure	1,radiko
la	el/la, els/les	1,artikolo
patro	pare	1,radiko
in	femení	1,sufikso
de	de, des de	1,prepozicio
ne	no	1,partikulo
ili	ells / elles	1,pronomo
labori	treballar	1,radiko
hotelo	hotel	1,radiko
instrui	ensenyar, instruir	1,radiko
ŝi	ella	1,pronomo
havi	tenir	2,radiko
n	acusatiu	2,finaĵo
nomo	nom	2,radiko
Ana	Anna	2,nomo
juna	jove	2,radiko
bela	bonic/a, bell/a, maco/a	2,radiko
ge	(ambdós sexes inclosos)	2,prefikso
veni	venir	2,radiko
is	verb en passat	2,finaĵo
al	a, cap a, vers	2,prepozicio
hejmo	casa, llar	2,radiko
bona	bo/bona	2,radiko
voli	voler	2,radiko
u	volitiu	2,finaĵo
iri	anar	2,radiko
i	infinitiu	2,finaĵo
saluto	saludar	2,radiko
kio	què, quina cosa	2,tabelvorto
vi	tu, vos, vostè, vosaltres, vostès	2,pronomo
fari	fer	2,radiko
legi	llegir	2,radiko
sed	però	2,konjunkcio
paroli	parlar	2,radiko
kun	amb, acompanyat de	2,prepozicio
ĉu	¿, És que	2,partikulo
jes	sí	2,adverbo
ŝati	agradar, valorar, preuar, apreciar	2,radiko
nur	només	2,adverbo
trinki	beure	2,radiko
kafo	cafè	2,radiko
frato	germà	2,radiko
jen	heus aquí, vet aquí, aquí tens	2,partikulo
ankoraŭ	encara	2,adverbo
varma	calent/a	2,radiko
kuiri	cuinar	2,radiko
danki	agrair (a)	2,radiko
povi	poder	2,radiko
ankaŭ	també	2,adverbo
mal	(contrari, antònim)	2,prefikso
rigardi	mirar	2,radiko
okulo	ull	2,radiko
vidi	veure	2,radiko
ke	que	2,konjunkcio
ami	estimar, amar	2,radiko
longa	llarg/a (distància o temps)	3,radiko
e	adverbi	3,finaĵo
antaŭ	davant, abans	3,prepozicio
ej	lloc	3,sufikso
post	darrere, després	3,prepozicio
ĝoja	alegrar-se, estar content/a, feliç	3,radiko
tra	a través, de banda a banda	3,prepozicio
strato	carrer	3,radiko
tago	dia	3,radiko
kuko	pastís	3,radiko
ni	nosaltres	3,pronomo
manĝi	menjar	3,radiko
diri	dir	3,radiko
sufiĉa	suficient, bastant, prou	3,radiko
mono	diners	3,radiko
kompreni	entendre	3,radiko
ebl	possible	3,sufikso
cent	cent	3,cifero
dolaro	dòlar	3,radiko
ho	ho	3,interjekcio
riĉa	ric/a	3,radiko
kelnero	cambrer/a	3,radiko
porti	portar	3,radiko
multa	molt/a	3,radiko
nova	nou/nova	3,radiko
serĉi	buscar, cercar	3,radiko
unu	u/un/una	3,cifero
loko	lloc	3,radiko
alia	altre/a	3,radiko
vizaĝo	cara	3,radiko
fini	acabar	3,radiko
per	mitjançant, amb	3,prepozicio
forta	fort/a	3,radiko
voĉo	veu	3,radiko
okazi	succeir, esdevenir, passar, tenir lloc	3,radiko
scii	saber	3,radiko
letero	carta	4,radiko
vera	veritable, veritat	4,radiko
foto	foto	4,radiko
kiam	quan	4,tabelvorto
re	de nou, altra vegada, repetició	4,prefikso
el	de (origen, composició)	4,prepozicio
rapida	ràpid/a	4,radiko
tie	allà	4,tabelvorto
stari	estar dret, dempeus	4,radiko
Vera	Vera	4,nomo
mano	mà	4,radiko
koleri	estar enfadat	4,radiko
iĝ	esdevenir, convertir-se en, passar a ser/estar	4,sufikso
ruĝa	roig/roja	4,radiko
fali	caure	4,radiko
pardoni	perdonar	4,radiko
doni	donar	4,radiko
ricevi	rebre	4,radiko
leciono	lliçó	4,radiko
plu	més (durada en el temps)	4,adverbo
os	verb en futur	4,finaĵo
devi	haver de, deure (estar obligat a)	4,radiko
fermi	tancar	4,radiko
pordo	porta	4,radiko
sinjoro	senyor	5,radiko
vendi	vendre	5,radiko
aŭto	cotxe	5,radiko
kiu	qui, quin, quina	5,tabelvorto
plaĉi	agradar	5,radiko
demandi	preguntar	5,radiko
plej	més (superlatiu)	5,adverbo
tiu	aquell, aquella	5,tabelvorto
ĉi	(partícula que indica proximitat, junt amb un correlatiu normalment)	5,partikulo
ĉiu	cada, cadascú, tots, tothom	5,tabelvorto
pli	més (comparatiu)	5,adverbo
ol	que (comparatiu)	5,konjunkcio
tre	molt	5,adverbo
certa	cert/a, segur/a	5,radiko
kosti	costar	5,radiko
bedaŭri	lamentar, deplorar	5,radiko
ind	que val la pena	5,sufikso
aĉeti	comprar	5,radiko
ĉar	perquè	5,konjunkcio
veturi	anar (amb vehicle)	5,radiko
dum	durant, mentres	5,prepozicio
tio	allò, això, ho	5,tabelvorto
edzo	marit	5,radiko
Maja	Maia	6,nomo
et	petit	6,sufikso
ul	individu	6,sufikso
tri	tres	6,cifero
ig	causar alguna cosa	6,sufikso
sana	sà/sana	6,radiko
alta	alt/a	6,radiko
temperaturo	temperatura	6,radiko
resti	romandre, quedar-se	6,radiko
morgaŭ	demà	6,adverbo
voki	cridar (fer venir algú, avisar)	6,radiko
doktoro	doctor	6,radiko
je	a (comodí)	6,prepozicio
naŭ	nou	6,cifero
horo	hora	6,radiko
por	per a, per tal de, a fi de	6,prepozicio
helpi	ajudar	6,radiko
montri	mostrar, ensenyar	6,radiko
piedo	peu	6,radiko
vesti	vestir	6,radiko
ĉio	tot	6,tabelvorto
fine	finalment, a la fi	6,vorto
semajno	setmana	6,radiko
sub	sota	6,prepozicio
teo	te (planta)	6,radiko
mateno	matí	6,radiko
vespero	vespre	6,radiko
deziri	desitjar	6,radiko
trankvila	tranquil/tranquil·la	6,radiko
farti	estar, sentir-se, trobar-se	6,radiko
eg	gran	6,sufikso
Karlo	Carles	6,nomo
		6,
dormi	dormir	7,radiko
suno	sol (astre)	7,radiko
subita	sobtat, de sobte	7,radiko
ek	(començament d'una acció), (acció momentània)	7,prefikso
salti	saltar	7,radiko
ĉiam	sempre	7,tabelvorto
frua	d'hora, aviat	7,radiko
hodiaŭ	avui	7,adverbo
meti	posar, ficar	7,radiko
aĵ	cosa, objecte	7,sufikso
kuri	córrer	7,radiko
laŭ	segons, arran, al llarg de	7,prepozicio
homo	persona, ésser humà	7,radiko
kia	com (sentit adjectiu, no adverbial), quina mena de	7,tabelvorto
saĝa	savi/sàvia	7,radiko
knabo	noi	7,radiko
baldaŭ	aviat	7,adverbo
it	passat passiu	7,participo
nek	ni	7,konjunkcio
pensi	pensar	7,radiko
diablo	diable	7,radiko
memori	recordar	7,radiko
dimanĉo	diumenge	7,radiko
raporti	informar	8,radiko
noto	nota	8,radiko
aĉ	lleig	8,sufikso
kapo	cap (part superior del cos)	8,radiko
kiom	quant, quants/quantes	8,tabelvorto
da	de (quantitat)	8,prepozicio
ĉe	a tocar, a casa de	8,prepozicio
ludi	jugar	8,radiko
mem	un mateix, per si sol	8,partikulo
tiom	tant, tants/tantes	8,tabelvorto
kvankam	encara que	8,konjunkcio
tiam	llavors, aleshores, en aquell moment	8,tabelvorto
aŭdi	sentir, oir	8,radiko
vorto	paraula	8,radiko
tuj	desseguida, immediatament	8,adverbo
respondi	respondre	8,radiko
kara	estimat/da, benvolgut/da	8,radiko
problemo	problema	8,radiko
pri	pel que fa a, sobre (temàtica)	8,prepozicio
muziko	música	8,radiko
ridi	riure	8,radiko
tamen	tanmateix	8,adverbo
Petro	Pere	9,nomo
Maria	Maria	9,nomo
vojaĝi	viatjar	9,radiko
lando	país, territori	9,radiko
libera	lliure	9,radiko
tempo	temps	9,radiko
decidi	decidir	9,radiko
italio	Itàlia	9,radiko
urbo	ciutat	9,radiko
feliĉa	feliç	9,radiko
kie	on	9,tabelvorto
forgesi	oblidar	9,radiko
esperi	tenir esperança	9,radiko
us	verb en condicional	9,finaĵo
komenci	començar	9,radiko
jam	ja	9,adverbo
vagono	vagó	9,radiko
ar	conjunt	9,sufikso
nenio	res, no res	9,tabelvorto
sekreto	secret	9,radiko
onklo	oncle	9,radiko
Bonifacio	Bonifaci	9,nomo
plena	ple/plena	9,radiko
um	significat indefinit (comodí per diferenciar sentit o matís)	9,sufikso
sia	pronom reflexiu	9,radiko
uzi	usar, emprar	9,radiko
domo	casa, edifici	9,radiko
ad	acció continuada	9,sufikso
atendi	esperar	9,radiko
do	per tant	9,adverbo
kial	per què	9,tabelvorto
neniam	mai (en negacions)	9,tabelvorto
kiel	com (sentit adverbial)	10,tabelvorto
pasi	passar	10,radiko
naski	engendrar	10,radiko
kelka	alguns/algunes	10,radiko
familio	família	10,radiko
an	membre, partidari	10,sufikso
iom	una mica, una certa quantitat, gens (en preguntes)	10,tabelvorto
trovi	trobar	10,radiko
almenaŭ	almenys	10,adverbo
ordo	ordre, endreç	10,radiko
io	alguna cosa, quelcom	10,tabelvorto
manki	faltar, mancar	10,radiko
lakto	llet	10,radiko
necesa	necessari/a	10,radiko
anstataŭ	en comptes de	10,prepozicio
intereso	interessar	10,radiko
ekskurso	excursió	10,radiko
klubo	club	10,radiko
ĵeti	tirar, llançar	10,radiko
ia	alguna mena de	10,tabelvorto
uj	contenidor, arbre, país	10,sufikso
ĝusta	correcte	10,radiko
		10,
inter	entre	10,prepozicio
sama	mateix/a	10,radiko
fojo	vegada, cop	10,radiko
rajti	poder, tenir dret (a)	10,radiko
proponi	proposar	10,radiko
du	dos/dues	10,cifero
parto	part	10,radiko
sukceso	tenir èxit	10,radiko
iu	algú, algun, alguna	10,tabelvorto
ideo	idea	10,novaj
tro	massa	10,adverbo
ec	qualitat abstracta	10,sufikso
reala	real	10,radiko
silento	callar, estar en silenci	10,radiko
daŭri	durar	10,radiko
nu	bé/bé doncs	10,interjekcio
minuto	minut	10,radiko
telefono	telèfon	10,radiko
viziti	visitar	10,radiko
dolĉa	dolç/a	10,radiko
atenti	estar atent, parar atenció	10,radiko
dika	gras/grassa	10,radiko
ŝanĝi	canviar	10,radiko
opinii	opinar	10,radiko
sen	sense	10,prepozicio
sola	sol/a, únic/a	10,radiko
Veneci	Venècia	11,radiko
Sankt-Mark	Sant Marc	11,nomo
placo	plaça	11,radiko
milito	guerra	11,radiko
maro	mar	11,radiko
ŝipo	vaixell	11,radiko
gondolo	góndola	11,radiko
movi	moure	11,radiko
mezo	mig (ubicació)	11,radiko
proksima	proper/a, pròxim/a	11,radiko
granda	gran	11,radiko
oni	se, un (hom), la gent	11,pronomo
facila	fàcil	11,radiko
lumo	llum	11,radiko
flanko	costat	11,radiko
Stefan	Esteve	11,nomo
krii	cridar	11,radiko
turko	turc/a	11,radiko
renkonti	trobar-se (amb), topar	11,radiko
sekvi	seguir	11,radiko
Pietro	Pietro	11,nomo
koni	conèixer	11,radiko
akvo	aigua	11,radiko
tiel	així, d'aquesta manera, tan	11,tabelvorto
Ĝorĝo	Ĝorĝo	11,nomo
preni	prendre	11,radiko
estro	cap, màxima autoritat	11,sufikso
preskaŭ	quasi	11,adverbo
morti	morir	11,radiko
grava	important	11,radiko
Ĝino	Ĝino	11,nomo
halti	aturar-se, parar-se	11,radiko
apud	al costat de	11,prepozicio
dek	deu	11,cifero
jaro	any	11,radiko
koloro	color	11,radiko
Jakopo	Jaume	11,nomo
tial	per tal raó, per tal motiu, per això	11,tabelvorto
timi	témer, tenir por	11,radiko
sendi	enviar	11,radiko
doĝo	dux	11,radiko
bezoni	necessitar	11,radiko
pagi	pagar	11,radiko
er	fragment, peça petita, partícula	11,sufikso
afero	assumpte, cosa	11,radiko
se	si (condicional)	11,konjunkcio
pano	pa	11,radiko
Don Kamilo	Don Camilo	11,nomo
ĝis	fins	11,prepozicio
S-ro	Sr.	12,mallongigo
Pipelbom	Pipelbom	12,nomo
peza	pesar (tenir pes)	12,radiko
larĝa	ample/a	12,radiko
korpo	cos	12,radiko
aspekto	semblar (aspecte)	12,radiko
rolo	paper, rol	12,radiko
fakto	fet	12,radiko
respekti	respectar	12,radiko
kontenta	satisfet/a, content/a	12,radiko
ofte	freqüent, sovint	12,radiko
utila	útil	12,radiko
prezenti	presentar	12,radiko
ĝeni	molestar, fer nosa	12,radiko
nokto	nit	12,radiko
arbo	arbre	12,radiko
ĉefo	cap (directiu)	12,radiko
vojo	camí	12,radiko
ekster	fora de	12,prepozicio
sovaĝa	salvatge	12,radiko
bruo	soroll	12,radiko
krom	a més de, a banda de, excepte	12,prepozicio
tuŝi	tocar	12,radiko
naturo	natura	12,radiko
ĝenerali	general	12,radiko
seki	sec/a	12,radiko
paŝi	caminar, pas, passa	12,radiko
vivi	viure	12,radiko
dolori	fer mal, doler	12,radiko
agrabla	agradable	12,radiko
ju	quant	12,partikulo
kastelo	castell	12,radiko
des	tant	12,partikulo
Adriano	Adrià	12,nomo
viro	home, mascle	12,radiko
kapabla	capaç	12,radiko
industrio	indústria	12,radiko
polico	policía	12,radiko
persono	persona, personatge	12,radiko
simila	similar, semblant	12,radiko
lasta	últim/a	12,radiko
laŭta	fort/a (so)	12,radiko
orelo	orella	12,radiko
momento	moment	12,radiko
ambaŭ	ambdós, ambdues	12,adverbo
direkti	direcció	12,radiko
zorgi	ocupar-se, tenir cura (de), preocupar-se, amoïnar-se	12,radiko
situacio	situació	12,radiko
branĉo	branca	12,radiko
rekta	directe/a	12,radiko
besto	animal	12,radiko
promeni	passejar	12,radiko
kavo	cavitat	12,radiko
odoro	fer olor	12,radiko
preta	llest, a punt, preparat/da	12,radiko
ajn	qualsevol	12,partikulo
efektiva	efectiu	12,radiko
miri	meravellar-se, admirar-se, preguntar-se	12,radiko
koro	cor	12,radiko
ŝajni	semblar	12,radiko
supri	(a) dalt	12,radiko
buŝo	boca	12,radiko
provi	intentar, provar	12,radiko
kapti	atrapar, capturar, segrestar	12,radiko
lampo	làmpada	12,radiko
paco	pau	12,radiko
formo	forma	12,radiko
teni	sostenir	12,radiko
sono	sonar	12,radiko
aŭtoritato	autoritat	12,radiko
nuuuu	nuuuu	12,interjekcio
eee	eee	12,interjekcio
fuŝi	espatllar, malmetre, esguerrar	12,radiko
klara	clar	12,radiko
eĉ	inclús, fins i tot	12,adverbo
tono	to	12,radiko
ha	ha	12,interjekcio
bieno	terreny, finca	12,radiko
grafo	comte	12,radiko
monto	muntanya	12,radiko
kalva	calv/a	12,radiko
inviti	invitar, convidar	12,radiko
peti	demanar	12,radiko
teroro	terror	12,radiko
kontroli	controlar, comprovar	12,radiko
ĉirkaŭ	al voltant de	12,prepozicio
akcepti	acceptar	12,radiko
perdi	perdre	12,radiko
