Marko	Marko	1,nomo
esti	adalah (to be), ada	1,radiko
as	Kata kerja bentuk sekarang (present)	1,finaĵo
mi	saya	1,pronomo
a	Adjektif (kata sifat)	1,finaĵo
amiko	teman	1,radiko
o	Kata Benda	1,finaĵo
li	dia (laki-laki)	1,pronomo
lerni	belajar	1,radiko
ant	kata kerja aktif di masa sekarang (present active)	1,participo
kaj	dan	1,konjunkcio
sporto	olahraga	1,radiko
ist	profesi, pelaku kebiasaan	1,sufikso
nun	sekarang	1,adverbo
sidi	duduk	1,radiko
en	di dalam	1,prepozicio
ĉambro	kamar	1,radiko
sur	pada	1,prepozicio
tablo	meja	1,radiko
papero	kertas	1,radiko
j	Plural	1,finaĵo
libro	buku	1,radiko
ĝi	itu (benda, binatang)	1,pronomo
skribi	tulis	1,radiko
la	(artikel definitif) the	1,artikolo
patro	ayah	1,radiko
in	perempuan	1,sufikso
de	dari, tentang	1,prepozicio
ne	tidak, bukan	1,partikulo
ili	mereka	1,pronomo
labori	kerja	1,radiko
hotelo	hotel	1,radiko
instrui	mengajar	1,radiko
ŝi	dia (perempuan)	1,pronomo
havi	punya	2,radiko
n	Akusatif	2,finaĵo
nomo	nama	2,radiko
Ana	Ana	2,nomo
juna	muda	2,radiko
bela	cantik	2,radiko
ge	menyatakan bentuk yang mencakup perempuan dan laki-laki	2,prefikso
veni	datang	2,radiko
is	Kata kerja bentuk lampau (past)	2,finaĵo
al	ke, menuju	2,prepozicio
hejmo	rumah	2,radiko
bona	baik	2,radiko
voli	mau, ingin	2,radiko
u	Kata kerja Imperatif	2,finaĵo
iri	pergi	2,radiko
i	Infinitif (Kata kerja bentuk dasar)	2,finaĵo
saluto	sapa	2,radiko
kio	apa, yang	2,tabelvorto
vi	kamu, Anda, kalian	2,pronomo
fari	buat, lakukan	2,radiko
legi	baca	2,radiko
sed	tapi	2,konjunkcio
paroli	bicara	2,radiko
kun	dengan	2,prepozicio
ĉu	apakah	2,partikulo
jes	ya	2,adverbo
ŝati	suka	2,radiko
nur	hanya	2,adverbo
trinki	minum	2,radiko
kafo	kopi	2,radiko
frato	saudara	2,radiko
jen	inilah	2,partikulo
ankoraŭ	masih, tetap	2,adverbo
varma	panas	2,radiko
kuiri	masak	2,radiko
danki	terima kasih	2,radiko
povi	bisa	2,radiko
ankaŭ	juga	2,adverbo
mal	lawan kata	2,prefikso
rigardi	memandang	2,radiko
okulo	mata	2,radiko
vidi	lihat	2,radiko
ke	bahwa	2,konjunkcio
ami	cinta	2,radiko
longa	panjang	3,radiko
e	Adverb (Kata Keterangan)	3,finaĵo
antaŭ	sebelum, di depan	3,prepozicio
ej	tempat	3,sufikso
post	setelah	3,prepozicio
ĝoja	senang	3,radiko
tra	melalui	3,prepozicio
strato	jalan	3,radiko
tago	hari	3,radiko
kuko	kue	3,radiko
ni	kami	3,pronomo
manĝi	makan	3,radiko
diri	bilang	3,radiko
sufiĉa	cukup	3,radiko
mono	uang	3,radiko
kompreni	paham	3,radiko
ebl	kemampuan	3,sufikso
cent	seratus	3,cifero
dolaro	dolar	3,radiko
ho	oh	3,interjekcio
riĉa	kaya	3,radiko
kelnero	pelayan	3,radiko
porti	bawa	3,radiko
multa	banyak	3,radiko
nova	baru	3,radiko
serĉi	cari	3,radiko
unu	satu	3,cifero
loko	tempat	3,radiko
alia	lain	3,radiko
vizaĝo	wajah	3,radiko
fini	akhir	3,radiko
per	dengan cara, menggunakan	3,prepozicio
forta	kuat	3,radiko
voĉo	suara	3,radiko
okazi	terjadi	3,radiko
scii	tahu	3,radiko
letero	surat	4,radiko
vera	benar, sejati	4,radiko
foto	foto	4,radiko
kiam	ketika	4,tabelvorto
re	lagi, re-	4,prefikso
el	dari	4,prepozicio
rapida	cepat	4,radiko
tie	di sana	4,tabelvorto
stari	berdiri	4,radiko
Vera	Vera	4,nomo
mano	tangan	4,radiko
koleri	marah	4,radiko
iĝ	menjadi	4,sufikso
ruĝa	merah	4,radiko
fali	jatuh	4,radiko
pardoni	memaafkan	4,radiko
doni	beri	4,radiko
ricevi	menerima	4,radiko
leciono	pelajaran	4,radiko
plu	lagi	4,adverbo
os	Kata kerja bentuk masa depan (future)	4,finaĵo
devi	harus	4,radiko
fermi	tutup	4,radiko
pordo	pintu	4,radiko
sinjoro	tuan, Tn.	5,radiko
vendi	jual	5,radiko
aŭto	mobil	5,radiko
kiu	siapa, yang, yang mana	5,tabelvorto
plaĉi	menyenangkan	5,radiko
demandi	tanya	5,radiko
plej	paling (superlatif)	5,adverbo
tiu	itu	5,tabelvorto
ĉi	~ini	5,partikulo
ĉiu	semua orang, setiap	5,tabelvorto
pli	lebih (komparatif)	5,adverbo
ol	daripada	5,konjunkcio
tre	sangat	5,adverbo
certa	yakin	5,radiko
kosti	harga	5,radiko
bedaŭri	sesal	5,radiko
ind	pantas di	5,sufikso
aĉeti	beli	5,radiko
ĉar	karena	5,konjunkcio
veturi	pergi, perjalanan	5,radiko
dum	selama, ketika	5,prepozicio
tio	itu	5,tabelvorto
edzo	suami	5,radiko
Maja	Maya	6,nomo
et	kecil	6,sufikso
ul	orang	6,sufikso
tri	tiga	6,cifero
ig	menyebabkan sesuatu	6,sufikso
sana	sehat	6,radiko
alta	tinggi	6,radiko
temperaturo	temperatur	6,radiko
resti	sisa	6,radiko
morgaŭ	besok	6,adverbo
voki	panggil	6,radiko
doktoro	dokter	6,radiko
je	pada	6,prepozicio
naŭ	sembilan	6,cifero
horo	jam	6,radiko
por	untuk	6,prepozicio
helpi	bantu	6,radiko
montri	memperlihatkan	6,radiko
piedo	kaki	6,radiko
vesti	berpakaian	6,radiko
ĉio	semuanya	6,tabelvorto
fine	akhirnya	6,vorto
semajno	minggu	6,radiko
sub	di bawah, di balik	6,prepozicio
teo	teh	6,radiko
mateno	pagi	6,radiko
vespero	malam	6,radiko
deziri	ingin	6,radiko
trankvila	tenang	6,radiko
farti	merasa, (menerangkan keadaan)	6,radiko
eg	besar, meningkatkan	6,sufikso
Karlo	Karlo	6,nomo
hm	hm	6,interjekcio
dormi	tidur	7,radiko
suno	matahari	7,radiko
subita	tiba-tiba	7,radiko
ek	awal dari sebuah tindakan, tiba-tiba	7,prefikso
salti	lompat	7,radiko
ĉiam	selalu, setiap saat	7,tabelvorto
frua	awal	7,radiko
hodiaŭ	hari ini	7,adverbo
meti	taruh, simpan	7,radiko
aĵ	benda, perwujudan segala sesuatu yang konkrit	7,sufikso
kuri	lari	7,radiko
laŭ	berdasarkan, menurut	7,prepozicio
homo	manusia	7,radiko
kia	jenis apa, betapa	7,tabelvorto
saĝa	bijak	7,radiko
knabo	anak laki-laki	7,radiko
baldaŭ	segera	7,adverbo
it	kata kerja pasif di masa lampau (past passive)	7,participo
nek	bukan (… ataupun)	7,konjunkcio
pensi	pikir	7,radiko
diablo	setan	7,radiko
memori	ingat	7,radiko
dimanĉo	Minggu	7,radiko
raporti	lapor	8,radiko
noto	catat	8,radiko
aĉ	menyatakan kualitas yang tidak diinginkan	8,sufikso
kapo	kepala	8,radiko
kiom	seberapa banyak	8,tabelvorto
da	dari, tentang	8,prepozicio
ĉe	di	8,prepozicio
ludi	main	8,radiko
mem	(diri) sendiri	8,partikulo
tiom	sejumlah itu	8,tabelvorto
kvankam	meskipun	8,konjunkcio
tiam	waktu itu	8,tabelvorto
aŭdi	dengar	8,radiko
vorto	kata	8,radiko
tuj	langsung, segera	8,adverbo
respondi	menjawab	8,radiko
kara	sayang,	8,radiko
problemo	masalah	8,radiko
pri	tentang, mengenai	8,prepozicio
muziko	musik	8,radiko
ridi	tawa	8,radiko
tamen	bagaimanapun	8,adverbo
Petro	Petro	9,nomo
Maria	Maria	9,nomo
vojaĝi	perjalanan	9,radiko
lando	negeri	9,radiko
libera	gratis, bebas	9,radiko
tempo	waktu	9,radiko
decidi	memutuskan	9,radiko
italio	Itali	9,radiko
urbo	kota	9,radiko
feliĉa	bahagia, senang	9,radiko
kie	di mana	9,tabelvorto
forgesi	lupa	9,radiko
esperi	berharap	9,radiko
us	Kata kerja dalam bentuk kondisional	9,finaĵo
komenci	mulai	9,radiko
jam	sudah	9,adverbo
vagono	gerbong, kereta	9,radiko
ar	grup, sekumpulan	9,sufikso
nenio	tidak ada sesuatu	9,tabelvorto
sekreto	rahasia	9,radiko
onklo	paman	9,radiko
Bonifacio	Bonifasius	9,nomo
plena	penuh	9,radiko
um	makna yang tidak tentu	9,sufikso
sia	(kata ganti refleksif)	9,radiko
uzi	pakai, guna	9,radiko
domo	rumah	9,radiko
ad	perbuatan yang berulang-ulang	9,sufikso
atendi	tunggu	9,radiko
do	jadi	9,adverbo
kial	mengapa	9,tabelvorto
neniam	tidak pernah	9,tabelvorto
kiel	bagaimana	10,tabelvorto
pasi	lewat	10,radiko
naski	melahirkan	10,radiko
kelka	beberapa	10,radiko
familio	keluarga	10,radiko
an	anggota sebuah kelompok	10,sufikso
iom	sejumlah	10,tabelvorto
trovi	menemukan	10,radiko
almenaŭ	setidaknya	10,adverbo
ordo	suruh, perintah	10,radiko
io	sesuatu	10,tabelvorto
manki	kurang	10,radiko
lakto	susu	10,radiko
necesa	perlu, butuh	10,radiko
anstataŭ	alih-alih	10,prepozicio
intereso	tertarik	10,radiko
ekskurso	ekskursi, perjalanan wisata	10,radiko
klubo	klub	10,radiko
ĵeti	lempar	10,radiko
ia	sejenis, semacam	10,tabelvorto
uj	wadah, pohon, negara	10,sufikso
ĝusta	benar, tepat	10,radiko
for	jauh	10,prefikso
inter	di antara	10,prepozicio
sama	sama	10,radiko
fojo	kali, kejadian	10,radiko
rajti	berhak	10,radiko
proponi	usul	10,radiko
du	dua	10,cifero
parto	bagian	10,radiko
sukceso	sukses	10,radiko
iu	seseorang	10,tabelvorto
ideo	ide	10,novaj
tro	terlalu	10,adverbo
ec	kualitas abstrak	10,sufikso
reala	asli	10,radiko
silento	senyap, diam	10,radiko
daŭri	lanjut	10,radiko
nu	yah	10,interjekcio
minuto	menit	10,radiko
telefono	telepon	10,radiko
viziti	kunjung	10,radiko
dolĉa	manis	10,radiko
atenti	perhatian	10,radiko
dika	tebal, gemuk	10,radiko
ŝanĝi	ubah	10,radiko
opinii	opini, pendapat	10,radiko
sen	tanpa	10,prepozicio
sola	sendiri	10,radiko
Veneci	Venezia	11,radiko
Sankt-Mark	Santo Markus	11,nomo
placo	tempat	11,radiko
milito	perang	11,radiko
maro	laut	11,radiko
ŝipo	kapal	11,radiko
gondolo	gondola	11,radiko
movi	bergerak, pindah	11,radiko
mezo	tengah	11,radiko
proksima	dekat	11,radiko
granda	besar, hebat	11,radiko
oni	seseorang, orang	11,pronomo
facila	gampang	11,radiko
lumo	cahaya	11,radiko
flanko	sisi	11,radiko
Stefan	Stephen	11,nomo
krii	teriak	11,radiko
turko	Turki	11,radiko
renkonti	menemui	11,radiko
sekvi	mengikuti	11,radiko
Pietro	Pietro	11,nomo
koni	tahu, kenal	11,radiko
akvo	air	11,radiko
tiel	seperti itu	11,tabelvorto
Ĝorĝo	George	11,nomo
preni	ambil	11,radiko
estro	kepala, pemimpin	11,sufikso
preskaŭ	hampir	11,adverbo
morti	mati	11,radiko
grava	penting	11,radiko
Ĝino	Ĝino	11,nomo
halti	berhenti	11,radiko
apud	di dekat, di samping	11,prepozicio
dek	sepuluh	11,cifero
jaro	tahun	11,radiko
koloro	warna	11,radiko
Jakopo	Jacob	11,nomo
tial	untuk alasan itu	11,tabelvorto
timi	takut	11,radiko
sendi	kirim	11,radiko
doĝo	doge	11,radiko
bezoni	butuh	11,radiko
pagi	bayar	11,radiko
er	bagian terkecil, partikel	11,sufikso
afero	hal	11,radiko
se	jika	11,konjunkcio
pano	roti	11,radiko
Don Kamilo	Don Kamilus	11,nomo
ĝis	sampai	11,prepozicio
S-ro	Tuan - Tn., Bapak - Bpk.	12,mallongigo
Pipelbom	Pipelbom	12,nomo
peza	berat	12,radiko
larĝa	luas	12,radiko
korpo	badan, tubuh	12,radiko
aspekto	tampak	12,radiko
rolo	peran	12,radiko
fakto	fakta	12,radiko
respekti	menghargai	12,radiko
kontenta	puas, senang	12,radiko
ofte	sering	12,radiko
utila	berguna	12,radiko
prezenti	menghadirkan	12,radiko
ĝeni	ganggu	12,radiko
nokto	malam	12,radiko
arbo	pohon	12,radiko
ĉefo	bos	12,radiko
vojo	jalan	12,radiko
ekster	di luar	12,prepozicio
sovaĝa	liar	12,radiko
bruo	ribut	12,radiko
krom	di samping itu, sebagai tambahan	12,prepozicio
tuŝi	memegang	12,radiko
naturo	alam	12,radiko
ĝenerali	umum	12,radiko
seki	kering	12,radiko
paŝi	langkah	12,radiko
vivi	hidup	12,radiko
dolori	sakit, menyakiti	12,radiko
agrabla	menyenangkan, baik (sifat)	12,radiko
ju	semakin (lebih, kurang)	12,partikulo
kastelo	kastil	12,radiko
des	semakin (lebih, kurang)	12,partikulo
Adriano	Adriano	12,nomo
viro	pria	12,radiko
kapabla	mampu	12,radiko
industrio	industri	12,radiko
polico	polisi	12,radiko
persono	orang	12,radiko
simila	mirip	12,radiko
lasta	terakhir	12,radiko
laŭta	keras (suara), kencang	12,radiko
orelo	telinga, kuping	12,radiko
momento	momen	12,radiko
ambaŭ	keduanya	12,adverbo
direkti	arah	12,radiko
zorgi	urus, peduli	12,radiko
situacio	situasi	12,radiko
branĉo	cabang	12,radiko
rekta	langsung	12,radiko
besto	hewan, binatang	12,radiko
promeni	jalan-jalan	12,radiko
kavo	gua	12,radiko
odoro	bau, cium	12,radiko
preta	siap	12,radiko
ajn	-pun	12,partikulo
efektiva	sebenarnya, nyata	12,radiko
miri	bayang	12,radiko
koro	hati	12,radiko
ŝajni	tampak	12,radiko
supri	atas	12,radiko
buŝo	mulut	12,radiko
provi	coba	12,radiko
kapti	tangkap	12,radiko
lampo	lampu	12,radiko
paco	damai	12,radiko
formo	bentuk	12,radiko
teni	pegang	12,radiko
sono	bunyi	12,radiko
aŭtoritato	kuasa	12,radiko
nuuuu	nuuuu	12,interjekcio
eee	eee	12,interjekcio
fuŝi	kacau	12,radiko
klara	jelas	12,radiko
eĉ	bahkan	12,adverbo
tono	nada	12,radiko
ha	ha	12,interjekcio
bieno	lahan, tanah	12,radiko
grafo	count, earl	12,radiko
monto	gunung	12,radiko
kalva	botak	12,radiko
inviti	undang	12,radiko
peti	meminta	12,radiko
teroro	teror	12,radiko
kontroli	periksa	12,radiko
ĉirkaŭ	sekitar	12,prepozicio
akcepti	terima	12,radiko
perdi	kehilangan	12,radiko
